ABEL: ADAM, CAIN, CANE, KANE, LOTS, PAST, RING, SAUL, SHIT
ABLE: BODY, CAIN, CANE, EVER, GOOD, JUST, KANE, KEEN, PURE, SIZE, SUIT, TEST, VERY, WILL
ACES: BRAG, CARD, CLUB, DICE, EVIL, FAIR, FOUR, LAND, LUCK
ACHE: ARSE, BACK, DULL, EVEN, FEET, GUTS, HEAD, HURT, LEGS, OUCH, PAIN, PANG, SORE, TIRE
ACID: BASE, BATH, BURN, DROP, DRUG, HEAD, JUNK, MIND, NICE, SALT, SOUR, TART, TEST, TRIP
ACNE: CURE, FACE, HAIR, RASH, SKIN, SPOT, WHAT
ACRE: AREA
ACTS: DAFT, DOES, MIME, PLAY
ADAM: ABEL, EDAM, EVEN, FIGS, KANE, LEAF, PURE, RIBS, SWAG
ADDS: SUMS
AEON: ANEW
AFAR: AWAY, FROM, GONE, HILL, HOME, LOIN, NEAR, POEM, SWIM, WEAR
AGED: AUNT, DEAD, FACE, GREY, LADY, POOR, TEEN, WEAK, WELL, WORN
AGER: TEEN
AGES: DARK, DAYS, ERAS, LONG, MANY, PAST, ROCK, TIME
AHOY: BOAT, BUOY, LAND, LOGS, MAST, MIST, SAIL, SHIP
AIDS: ARMS
AIRY: BIRD, COLD, COOL, FREE, HAIR, MIST, OPEN, PLAY, ROOM, SOAP, THIN, WIND
AJAR: AJAX, BEER, DISH, DOOR, OPEN, PINT
AJAX: AJAR
ALAN: ALAN, ALUN, BALL, BARR, BEST, BOLD, CAVE, DAVE, EDIT, FRED, GLEN, HUFF, KERR, KIND, LADD, LOVE, MALE, NEIL, OWEN, RYAN, SWAN, TAKE
ALAS: ALSO, AMEN, BLOW, LAST, PITY, POOR, SIGH, WELL
ALES: BEEF, BEER, HALF, HUNT, PALE, PUBS, SEAT, WINE
ALLY: BABA, BACK, DARK, HELP, JOIN, LANE, NAVY, PATH, ROAD, WIND
ALSO: ALAS, ELSE, EVEN, EVER, MINE, NEAR, ONLY, THAN, THEM, THEN, WELL, WITH
ALUN: ALAN
AMEN: ALAS, AMEN, ANEW, EVER, HYMN, LORD, OMEN, OVER
AMIS: AMOK
AMOK: AMIS, ARAB, BULL, COAT, MINI, MOCK, MUCK, RIOT, SAFE, TANK, WHAT, WILD
AMOS: BURP
ANAL: ORAL
ANDY: FLOE
ANEW: AEON, AMEN, ANON, BOOK, COME, DAYS, LIFE
ANNA: WIFE
ANNE: MARY
ANON: ANEW, ANON, EVER, LILY, POEM, POET, SKIN, SOON
ANTE: HERO, LOPE, MARY, NODE, POST, ROOM
ANTI: BODY, DEMO, JEWS, LOPE, TANK
ANTS: BEES, BUGS, DUNG, DUST, EGGS, HILL, ITCH, NEST, NICE, PEAS
ANUS: ARSE, BODY, FART, HOLE, LATE, LIFE, MOLE, PILE, REAR, RING, RUDE, SHIT, TASK, WARM, YEAR
APES: FILM, HAIR, ROCK
APEX: BASE, CONE, EDGE, HILL, PEAK, POOH, ROOT, STEM, STOP, TAIL
ARAB: AMOK, FIGS, PALM, TENT, WOGS
ARCH: BACK, BEND, CATS, DOME, DOOR, FOOT, GATE, HOLE, OVER, PETE, ROAD, SPAN, TALL, TYPE
AREA: ACRE, BARE, HAND, JUMP, LAND, LIVE, PLAN, PLAY, POSH, RING, ROAD, SIZE, SPAN, TOWN, UNIT, WIDE, YARD, ZONE
ARID: COLD, HEAT, LAND, MIND, SAND
ARMS: AIDS, BABE, BABY, BARE, BEAR, BODY, BOTH, COAT, FEET, FIRE, GUNS, HAND, HELD, LANK, LEGS, LIMB, LINK, LOGS, LOVE, PUBS, RACE, SWIM
ARMY: BASE, BULL, CAMP, CHAP, CRAG, DUTY, FLEE, GAME, GUNS, HOST, HUTS, JEEP, JOIN, JOKE, LEAD, LIFE, LIMY, LIST, LOOT, MESS, NAVY, NAZI, RANK, SPUD, TAGE, TANK, UNIT, YANK
ARSE: ACHE, ANUS, ARSE, BACK, BODY, BOOT, CUNT, FART, HEAD, HOLE, JOKE, MESS, REAR, RUDE, RUMP, SEAT, SHIT, SORE, TAIL
ARTS: CLUB, DEAN, EASY, FINE, HAIR, LAZY, LONE, POET, SOFT
ATOM: BOMB, DUST, EYES, SIZE, TINY
AUNT: AGED, BEES, BUNT, DAME, DEAR, ELSE, GAIN, GWEN, HAIR, IRIS, JOAN, MARY, MAUD, SODA
AUTO: TIRE
AVIV: TELL
AVON: DEEP, FORD, LADY, LORD, ROOM, SOAP, SWAN, TYRE, UPON
AWAY: AFAR, BALE, BEEN, BLEW, CAME, CAST, CHAT, COME, CONE, DIED, DIVE, DRAW, FELL, FILE, FIRE, FLEA, FLEE, FLOE, FROM, FURY, GAME, GAVE, GAZE, GIVE, GOES, GONE, GONG, GUNS, HAMS, HERE, HIDE, HOME, KEEP, KEPT, MADE, MOVE, NEAR, PAIL, PINE, PULL, RIDE, RODE, ROLL, ROME, RUSH, SAIL, SEND, SENT, STAY, SWAY, SWIM, TAKE, TEAR, THEN, TOOK, TURN, UNTO, WALK, WENT, WILT
AXES: AXIS
AXIS: AXES, AXLE, BOLD, CLUB, CONE, LINE, POLE, SPIN, WORD
AXLE: AXIS, KNOB, STUB
BABA: ALLY
BABE: ARMS, BABY, BATH, BLUE, BORN, DOLL, FACE, GIRL, LOVE, MILK, NEST, RUTH, SOFT, WOOD
BABY: ARMS, BABE, BARE, BATH, BAWL, BLUE, BORN, BRAT, BUNT, BURN, BURP, BUSH, CALF, CHAM, CRIB, DOLL, FACE, FEED, FOAL, FOOD, GIRL, HOWL, HUSH, LIFE, LOOK, MILK, OURS, PILL, PINK, PRAM, RICH, RISK, ROCK, SUCK, TINY, TOYS, TWIN, WAIL, WIFE, WIND, WOMB, YELL, YOUR
BACH: NICE, NOTE, PLAY, SLOW
BACK: ACHE, ALLY, ARCH, ARSE, BARE, BEND, BONE, BOOK, COAT, COME, CUTS, DOOR, DRAG, DRAW, DUCK, ECHO, EVER, FEED, FLAP, FLOG, FLOW, FOLD, FORE, FULL, GAVE, GIVE, GOES, HALF, HANG, HEEL, HELD, HERD, HIKE, HOLD, HOME, KEEP, KEPT, KICK, LACK, LAID, LASH, LATE, LEAN, LONG, LOOK, MOVE, PACK, PAIN, PAST, PLAY, POND, PULL, RACK, REAR, RIBS, ROOM, RUSH, SACK, SEAT, SEND, SIDE, SOON, SORE, STAB, TALK, TILT, TURN, UPON, WALK, WALL, WHIP, YARD
BAGS: BINS, CASE, COAL, COWS, EYES, FULL, GOLD, HAND, LOOT, LOTS, NUTS, PACK, RAGS, RATS, SACK, SOOT, WIND
BAIT: FISH, FOOD, GAME, GAOL, GRUB, HOOK, JAIL, LIVE, MICE, SATE, SLUG, TRAP, WARM, WORM
BAKE: BEAN, BURN, CAKE, CLAM, COOK, FAKE, FOOD, HALF, LOAF, MAKE, MEAT, OVEN, PIES, RAKE, TART, WELL
BALD: BARE, BAWL, BOLD, BOSS, COOT, DENT, HAIR, HARE, HEAD, MONK, PATE, SKIN
BALE: AWAY, BLEW, BLUE, CORN, FULL, GAOL, GOAT, HALE, SEAS, WARE, WOOL
BALL: ALAN, BASE, BATS, BELL, BLUE, BOWL, BULL, DROP, EYES, FALL, FIND, FIRE, FIST, FOOT, GALA, GAME, GOAL, GOLF, GONG, HALL, HAND, HIGH, HOLE, HOOP, HUNT, JACK, KICK, MASK, MEAT, MOTH, PANE, PING, PLAY, PULP, QUIZ, ROLL, ROOM, SAME, SHOT, SNOW, SODA, SPOT, STEW, TEAM, TIME, WOOL
BALM: HEAL
BAND: BIND, DRUM, FOLD, GONG, HAIR, HATS, HEAD, JAZZ, JIVE, KNOT, NECK, PLAY, PLOT, RING, SASH, SLIP, SONG, TIME, TRIO, TUBA, WAVE
BANG: BANG, BASH, BELL, BOMB, BONG, BOOM, BUMP, CLAP, DEAD, DOOR, DRUM, FIRE, FIZZ, GANG, GONG, GUNS, HOLE, HURT, JERK, JOLT, JUDO, JUMP, KILL, LOUD, MINE, PANG, POPS, ROCK, ROLL, SHOT, SNAP, STUB, TANK, THUD, WHAM
BANK: BOOK, CASH, CITY, CORK, COSH, DANK, DEBT, DIKE, FUND, GOLD, LEAN, LEFT, LIFT, LOAN, LOOT, NOTE, OWED, RAID, RATE, REED, SAFE, SAND, SAVE, SEAT, SWAG, TREE, TUBE, WANK, YANK
BANS: WHAM
BARB: HOOK
BARD: POET
BARE: AREA, ARMS, BABY, BACK, BALD, BEAR, BODY, BONE, BULB, DARE, FACE, FEET, FOOT, FULL, LEGS, NICE, NUDE, OPEN, SHOD, SKIN, SLAB, TITS, TREE, WIRE
BARK: BITE, DEER, DOGS, HIDE, HOWL, LOGS, MOSS, ROAR, SHIN, SHIP, TREE, TWIG, WOOF
BARN: CLUB, COWS, DOOR, FAIL, FARM, FOLK, LADY, LOFT, MIRE, RAPE, RATS, SHED, SILO, YARD
BARR: ALAN
BARS: BEER, CAGE, CROW, FOOD, GAOL, GATE, GOLD, IRON, JAIL, MARS, NICK, OPEN, PUBS, ROAR, RODS, SETS, TAPS
BASE: ACID, APEX, ARMY, BALL, CORE, DIRT, DRUM, EVIL, FOOT, HOME, IRON, LEAD, LIAR, LINE, MEAN, MENT, PEAK, POEM, RACE, ROCK, UNIT, VILE, WOOD
BASH: BANG, BASH, BIFF, BLOW, BOSH, COSH, DENT, FALL, FLAT, HARE, HASH, HEAD, MASH, WHAM
BASS: ROCK, TIRE, TONE, TUBA
BATH: ACID, BABE, BABY, BODY, BUNS, COLD, CUBE, DIRT, DRIP, FEET, FOAM, GALA, MASS, NUDE, PINE, PLUG, ROBE, ROOM, SCUM, SINK, SOAK, SOAP, SUDS, SWIM, TAPS, TILE, TIME, TOGA, TOWN, TUBE, WASH, WIFE
BATS: BALL, BEES, BELL, BRAS, CAVE, DARK, EARS, EERY, EYES, NUTS, OWLS, RATS, RUIN, STAB, WINE, WING
BAWL: BABY, BALD, HAIL, HAUL, HOWL, KIDS, LOUD, ROUT, SING, WAIL, WEEP, YELL
BEAK: BILL, BIRD, CLAW, DAVE, DOME, DUCK, GULL, HAWK, HEAD, HOOK, LEAK, LONG, NOSE, PECK, TAIL, WING
BEAM: BEAN, BENT, BOAT, GRIN, HELP, JUMP, LOAD, MAIN, PROW, RAYS, ROOF, SHIP, SLAB, TEAM, WIDE, WOOD
BEAN: BAKE, BEAM, BEEN, HEAD, HUFF, JACK, JUMP, MEAL, MEAN, PEAS, POLE, SEED, SOUP, TREE
BEAR: ARMS, BARE, BULL, COSY, CUBS, DOWN, FAIR, FEET, FLUE, GRIN, HATE, HOOD, HOPS, HUGE, LADY, LAIR, LION, LOAD, MALT, NUDE, PAIN, PAWS, POLE, RAGE, SKIN, TAME, WITH, WOLF
BEAT: BELT, BROW, BRUM, CANE, COOL, DEAD, DOWN, DRUM, EASY, FLOG, HEAT, HURT, JAZZ, JIVE, LACK, LASH, LICK, NICK, OARS, PAIN, RAVE, SEAT, SONG, TANK, TEEN, TIME, TIRE, TUNE, WELL, WHIP, WIFE
BEAU: BRUM, RAKE
BECK: BERG, HECK
BEDS: BUGS, GIRL, REST, SOFT, TWIN, WARD
BEEF: ALES, BOIL, BULL, CHAP, CHEF, CHOP, COLD, CORN, COWS, CUBE, FOOD, HAMS, HASH, LAMB, MEAT, PORK, RIBS, SEAT, SHIN, SIDE, SOUR, SPAM, STEW, SUET
BEEN: AWAY, BEAN, DONE, EVER, GONE, HAVE, HERE, PAST, SEEN, WENT, WERE
BEER: AJAR, ALES, BARS, BREW, BRIM, BULL, BURP, CANS, CASE, CLUB, DANK, DART, DEER, FAGS, FART, FIZZ, FOAM, FOUL, GILL, GOOD, GULP, HEAD, HELP, HOPS, LEER, LEES, MALT, MASK, MILD, MOST, MUST, PALE, PEER, PINT, POUR, ROOT, SEER, SODA, SONG, SPEW, SPIT, STEW, SWAG, TANG, TANK, TAPS, THUG, WEAK, WINE
BEES: ANTS, AUNT, BATS, BUGS, BUSY, BUZZ, HIVE, LEES, NEST, NOSE
BEET: BOOT, DRUM, FEET, KALE, ROOT
BELL: BALL, BANG, BATS, BELL, BIKE, BLUE, BOOK, CALL, DAMN, DARE, DELL, DESK, DIME, DING, DOME, DONG, DOOR, DUMB, DUNG, GOAT, GONG, HELL, HONK, LOOK, PING, PULL, RANG, RING, ROPE, RUNG, SASH, SLAY, TELL, TILL, TING, TOLD, TOLL, TONE, TRIO, TYPE, WAKE, WELL, WHOM, YELL
BELT: BEAT, BOUT, CARS, CLIP, CORD, FLOG, FOLD, HIPS, HURT, JUDO, MELT, PAIN, SASH, SEAT, STUD, TONG, WHIP
BEND: ARCH, BACK, BIAS, BUMP, CARD, CUBE, DOWN, FOLD, JERK, KNEE, LINE, LOOP, MEND, MIND, OVER, PIPE, REED, ROAD, SIDE, SNAP, SWAY, TILT, TUBE, TURN, WHIP, WILT, WIRE
BENT: BEAM, BIAS, BUNT, CANE, CENT, COIN, COMB, FLOG, HEAD, IRON, KINK, KNOB, LENT, MIND, NAIL, PIPE, POST, RENT, SAIL, SANE, SENT, SIDE, TENT, TWIG, WENT, WIDE
BERG: BECK, DAVE, FILM, FRED, SNOW, TOWN, URGE, WARG
BERT: CUFF, TRIO
BEST: ALAN, CHEF, DALE, EVER, FOOT, FOWL, GIVE, GOOD, LEST, MOST, NEST, PETE, SUIT, TIME, TOPS, VERY, WEST, WORK
BETS: LOTS, TIPS
BIAS: BEND, BENT, BIND, BOWL, BRAS, GAME, GRID, JOAN, LEAN, LEFT, LIST, SIDE, TILT
BIFF: BASH, COSH, WHAM
BIKE: BELL, BLUE, BRUM, GEAR, GOES, HACK, HIKE, HOME, LAMP, MIKE, PRAM, PUMP, PUSH, RIDE, RODE, RUST, SHED, TOWN, TREK, TYRE
BILE: BODY, BOOK, DUCT, GALL, GREY, PILE, PUKE, SHIP, SHIT, SICK, SPIT, VILE
BILL: BEAK, BULL, COST, DEBT, DUCK, FARE, FILL, FOLD, HELL, HILL, JANE, JOHN, LACY, LOVE, MARY, MATE, NOTE, OWED, PAID, PECK, PETE, POST, SHOP, SILL, TENT, TIDY, WILD
BIND: BAND, BIAS, BOOK, BORE, DARK, DATE, DEAF, DRAG, FEET, FOLD, GLUE, HOLD, JAIL, JOIN, MEND, MIND, OVER, ROPE, TAPE, WEED
BING: LINK, PITT
BINS: BAGS, LIDS, PANS
BIRD: AIRY, BEAK, BLOB, BLUE, BOLD, BUNT, BUSH, CAGE, CALL, COON, CROW, DATE, DISH, DOGS, DOLL, DOVE, DUCK, EERY, EGGS, FEED, FISH, FORM, FOUL, FOWL, FREE, GAME, GAOL, GIRL, GULL, HAND, HAWK, HIDE, JAIL, KANE, KISS, KITE, LADY, LASS, LONE, LOVE, MATE, MOCK, MOOT, MOTH, MUST, NEST, NOAH, OVEN, PECK, POLL, PREY, RARE, RENT, SEED, SEXY, SHOW, SILL, SOAR, SONG, SWAN, TAIL, TAME, TART, THIS, TITS, TOOT, TREE, TWIT, WING, WINK, WORM, YARD
BITE: BARK, BUGS, CHEW, DOGS, DUST, EARS, FANG, FLEA, FLEE, FOOD, GNAT, GNAW, HARD, HURT, ITCH, KISS, LOVE, MEAT, NAIL, NECK, PAIN, PECK, RATS, SKIN, SNAP, TAKE, TANG
BITS: BOBS, DUST, HARD, TITS
BLAB: CYST
BLAM: WHAM
BLED: BRED
BLEW: AWAY, BALE, BLOW, DOWN, FART, GUSH, HARD, HORN, HOSE, JOKE, NOSE, NOTE, PUFF, WIND, WING
BLOB: BIRD, BLOT, BOMB, CORK, DRIP, FLOB, GLUE, LUMP, MASS, NAME, SLOB, SMUT, SPOT
BLOC: INCA
BLOT: BLOB, CLOT, MARK, PLOT
BLOW: ALAS, BASH, BLEW, BODY, CLOT, COLD, COSH, COUP, CUFF, DAMN, DAZE, DOWN, FART, FIST, FLAP, GALE, GASP, HARD, HEAD, HEAT, HECK, HELL, HORN, HUFF, KICK, KISS, LAMP, MIND, NOSE, PIPE, PUFF, REED, SUCH, SUCK, SWAY, TENT, TOOT, TUBA, TYRE, WAVE, WHAM, WIND
BLUE: BABE, BABY, BALE, BALL, BELL, BIKE, BIRD, BOYS, BULK, CALM, CAPE, DARK, DEEP, DIED, DISC, ESSO, EYES, FILE, FILM, FLUE, FUME, GIRL, GRAY, GREY, HARD, HAZE, INCA, LAKE, LAMP, LINO, MARK, MARY, MOOD, MOON, NAVY, PALE, PINK, SAIL, SASH, SEAS, SEXY, SOAP, SOAR, SOHO, SUES, SUIT, SURE, TITS, TOOT, TORY, TRAY, TRUE, TWIT, VEST
BLUR: DAZE, DIME
BOAK: PUKE, SPEW
BOAR: HOAR, WILD
BOAT: AHOY, BEAM, BOOM, BOWS, CLUB, COVE, CREW, DECK, DOCK, FEND, FISH, FLAG, GOAT, HIRE, HOOK, IRIS, JEST, LAKE, LAND, LEAK, LEEK, LEND, LINK, LOCH, LONG, LOST, MAIL, MAST, NAVY, NOAH, OARS, OPEN, PAIL, PIER, POND, PORT, PROW, RACE, RIBS, RIDE, ROCK, SAIL, SALE, SANK, SEEN, SHIP, SHOW, SICK, SINK, SKIP, SKIT, SLOW, SOAK, SOIL, SONG, SPUD, SWAY, SWIM, TACK, TEAM, THUG, TRIM, TRIP, WAKE, WAVE, WOOD, YARD
BOBS: BITS
BODY: ABLE, ANTI, ANUS, ARMS, ARSE, BARE, BATH, BILE, BLOW, BONE, BUSY, CELL, CHIN, DARK, DEAD, FACE, FLEA, FORM, GOOD, HAND, HEAD, HEAP, HEAT, HIPS, LEGS, LICE, LIFE, LIMB, LINE, LOOM, LUST, MEAT, MIND, MIST, NECK, NICE, NUDE, RIBS, RUST, SAME, SKIN, SLAB, SOME, SOUL, TAIL, TANG, TITS, TRIM, WARM, WINK, WITH
BOER: TREK
BOFF: FART
BOGS: MOOR, WOGS
BOIL: BEEF, BREW, BRIM, COOK, CYST, DIRT, FISH, GUMS, HEAT, HURT, LARD, LEEK, LOGS, LUMP, MILK, NECK, OOZE, OVER, PAIN, PEAS, PUSS, RICE, SOIL, SORE, SPOT, STEW, WART
BOKE: PUKE, SPEW
BOLD: ALAN, AXIS, BALD, BIRD, COLD, DARE, DEED, FOLD, FREE, FUCK, HARD, HELD, HERO, KEEN, LOUD, LOVE, PATE, SOLD, TYPE, WEAK
BOLT: BOWS, JOLT, LOCK, NUTS, STUD
BOMB: ATOM, BANG, BLOB, BOOM, DEAD, DIVE, DOOM, DROP, DUMP, FIRE, HOAX, KILL, MINE, NESS, PLAY, RACK, RAID, SITE, SNOG, TIME, TOMB
BOND: DUTY, FIRM, FREE, GOLD, HERO, LINK, LOVE, NAME, OATH, ROPE, TALC, TIED
BONE: BACK, BARE, BODY, CHIN, CONE, DOME, FISH, HAND, HARD, HEAD, HEEL, IDLE, JOIN, KNEE, LIMB, MEAL, MEAT, PORK, RAGS, RIBS, SHIN, TONE, WISH
BONG: BANG, GONG, HONG
BONN: IZZY
BOOB: OOPS
BOOK: ANEW, BACK, BANK, BELL, BILE, BIND, CASE, CLIP, COOK, COPY, COST, DESK, DOOM, EDIT, ENDS, FILE, FLAP, GIFT, HAVE, HERO, HYMN, JOKE, LATE, LEAF, LEND, LIST, LOAN, LOGS, LOOK, MARK, NOTE, NOVA, OATH, OPEN, PAGE, PLAY, POEM, POET, PRAY, QUIZ, RACK, READ, REED, RENT, RULE, SHOP, SHUT, SMUT, TAKE, TEXT, THIN, TILE, TOOK, TREE, WHAM, WHEN, WORD, WORK, WORM, YEAR, YOUR
BOOM: BANG, BOAT, BOMB, BOOM, COON, DOOM, DRUM, LOOM, LOUD, LULU, MOOD, ROOM, SHIP, TOWN, WHAM
BOON: SOON
BOOT: ARSE, BEET, FOOT, GIRL, GLUM, GOSH, HIKE, JACK, KICK, LACE, LOOT, MOOT, PUMP, PUSS, ROOT, SHOD, SHOE, SHOP, SIZE, SMUT, SNOW, SOCK, SOLE, STEP, STUD, SWAG, TEXT
BORE: BIND, DEAD, DOWN, DRAG, DRIP, DULL, DUTY, EXAM, FILM, FLAT, HOLE, HOME, LOAD, MORE, NOPE, PEST, PIGS, POPE, ROBE, STAY, SWAG, THIS, TIRE, TUBE, WELL, WIRE, WORK, YAWN
BORN: BABE, BABY, BRED, BURN, CALF, DEAD, DIED, FREE, HERE, HYDE, LIAR, LIVE, MADE, TORN, WOMB
BOSH: BASH
BOSS: BALD, CITY, DEAN, DESK, FOOL, GANG, HEAD, HORN, MICK, POPE, RISE, SERF, TOSS, WIFE, WORK, YOUR
BOTH: ARMS, EACH, EARS, ENDS, HAVE, MOST, NONE, OATH, PAIR, SAME, THEM, WELL
BOTS: TOPS
BOUT: BELT, FIST, FLUE, RING, SAIL, SICK, WORK
BOWL: BALL, BIAS, BRAN, CROW, DISH, DUST, FEED, FISH, FULL, HOOP, MILK, MOAN, OVER, PINS, PIPE, RICE, SICK, SINK, SOUP, SPIN, SPIT, TOIL, VASE, WARE, WOOD
BOWS: BOAT, BOLT, BUNS, DOWN, FORE, HAIR, HATS, LEGS, PROW, SHIP, STEM
BOYS: BLUE, CHAP, CUBS, DIRT, FAGS, GANG, GIRL, KIDS, MOOR, SONS, SUIT, TOYS
BRAG: ACES, CARD, CROW, SWAG
BRAN: BOWL, BUDS, DISH, FARM, FIGS, FOOD, LOAF, MASH, MEAL, OATS, SHIT
BRAS: BATS, BIAS, TITS
BRAT: BABY, BRAT, BRAY, CUFF, FOOL, MITE, PEST, PLEB, TWIT
BRAY: BRAT
BRED: BLED, BORN, CALF, DOGS, FOOD, HACK, LIFE, MICE, WELL
BREW: BEER, BOIL, HOME, IRON, MASH, SONG, STEW, WINE
BRIM: BEER, BOIL, BRUM, DRIP, EDGE, FALL, FILL, FIRM, FUEL, FULL, OVER, PINT, SOUP, TRIM
BROW: BEAT, DARK, HAIR, HEAD, HEAT, HIGH, HILL, LINE, MEET, PATE, PROW, RISE, WIPE
BRUM: BEAT, BEAU, BIKE, BRIM, BRUM, CITY, CRUM, DRUM, GREY, HAIR, HOME, LOUT, PETE, ROLL, TALK
BUCK: DEER
BUDS: BRAN, GERM, HILL, PALS, ROSE, TREE
BUGS: ANTS, BEDS, BEES, BITE, CARS, DIRT, HAIR, ITCH, LICE, PEST
BULB: BARE, CONE, FLUX, GLOW, GROW, IRIS, KNEE, LAMP, NEON, TUBA
BULK: BLUE, FOOD, HUGE, HULL, LOAD, MASS, MORE, MOST, MUCH, SHIP, WOOD
BULL: AMOK, ARMY, BALL, BEAR, BEEF, BEER, BILL, BUSH, CALF, COCK, DOZE, DUST, FARM, GATE, GOAT, GORE, GULL, HEAD, HOAR, HORN, JOHN, REAR, RING, ROAR, RUSH, SHIT, STUD, TAIL, TORE, WHIP
BUMP: BANG, BEND, BUMP, BUNT, CYST, DROP, FALL, HARD, HEAD, HILL, HUMP, HURT, JOLT, JUMP, KILL, LIMP, LUMP, MEET, OUCH, PAIN, PUMP, PUSS, ROAD, SHIN, THUD
BUMS: GUMS, POET
BUNG: CORK
BUNK: BUNT
BUNS: BATH, BOWS, CAKE, FOOD, HAIR, ICED, OVEN, ROOM
BUNT: AUNT, BABY, BENT, BIRD, BUMP, BUNK, CROW, CUNT, FLAG, GALA, HUNT, HURT, JOKE, POLE, RUNT, SNOW, WHAT
BUOY: AHOY, GULL
BURK: SLOB, TWIT
BURN: ACID, BABY, BAKE, BORN, BUSH, CHAR, COAL, COKE, CUTS, FIRE, FUEL, GLOW, HAND, HEAT, HELL, HOLE, HURT, KILL, LOGS, MELT, OUCH, OVEN, PAIN, ROSE, SCAR, SEER, SORE, WICK, YANK
BURP: AMOS, BABY, BEER, COKE, CRAP, EATS, FART, FOOD, GOOD, GUTS, HICK, MEAL, OOPS, RUDE, SICK, WIND
BURY: COOK
BUSH: BABY, BIRD, BULL, BURN, DISC, FIRE, GOSH, HAND, HOLY, HUSH, LANE, LEAF, ROSE, RUSH, TAIL, TREE, WILD
BUST: CAST, HIPS, LUST, RAID, SACK, TITS
BUSY: BEES, BODY, DOER, FISH, GIRL, HARD, IDLE, IDOL, IZZY, KEPT, LAZY, LIFE, ROAD, RUSH, TIME, WORK
BUTE: ISLE
BUTT: HAMS, STUB
BUYS: TICK
BUZZ: BEES, FIZZ, FUZZ, GNAT
BYRE: PINT
CABS: TAXI
CAFE: CAFE, FISH, FOOD, MEAL, NOIR, PIES, SHOP, TEAS
CAGE: BARS, BIRD, CRIB, DOOR, LIFT, LION, RIBS, TRAP
CAIN: ABEL, ABLE, SLAY
CAKE: BAKE, BUNS, COOK, EATS, EGGS, FISH, FOOD, FOOL, HASH, JAMB, MADE, MAKE, NICE, OVEN, PART, PLUM, RAKE, RICH, RISE, ROCK, ROLL, SCUM, SEED, SHOP, SLAB, SOAP, TART, TEAS, WALK
CALF: BABY, BORN, BRED, BULL, FARM, FOAL, GOAT, HALF, HEEL, KNEE, LAMB, LEGS, MILK, SHIN, VEAL, WARM
CALL: BELL, BIRD, COME, DOES, GIRL, HAIL, HERE, LATE, NAME, PORT, ROLL, SAVE, SIGN, SING, WOLF
CALM: BLUE, COOL, EASE, EASY, FARM, FEAR, FIRE, FURY, MILD, POND, RAGE, SEAS, SILL, SOFT, TOMB
CAME: AWAY, COME, FROM, GONE, GOOD, HERE, HOME, INTO, NEAR, OVER, PLAY, RAIN, SENT, THEY, WENT, WITH
CAMP: ARMY, COVE, DRAG, FIRE, GEAR, HERE, HILL, HIRE, HUTS, NAVY, NUDE, OPEN, OURS, POOF, PUFF, REST, SAIL, SIDE, SITE, TENT, TEST
CANE: ABEL, ABLE, BEAT, BENT, COLE, HAND, KANE, LASH, LONG, OUCH, PAIN, RASP, VAIN, WALK, WAND, WHIP
CANS: BEER, COKE, FOOD, GAME, LIDS, MEAT, NEAT, OPEN, PANS, PEAS, TINS
CANT: CULT, CUNT, EVER, KANT, PUSH, RAVE, SECT, SING, SONG, TALK, TELL, TILT, WAIT, WHAT, WINE, WONT
CAPE: BLUE, COAT, GOWN, GREY, HEAD, HOOD, HOPE, HORN, MARY, NESS, RAIN, ROBE, TOWN
CAPS: HATS, TOPS
CARD: ACES, BEND, BRAG, CLUB, DEAL, DECK, DICE, FAKE, FILE, GAME, GIFT, KERB, KING, LOOP, PACK, PLAY, POST, SHOP, SNAP, SUIT, VIEW, WOOL
CARE: FORD, FREE, FULL, HELP, HOME, HOPE, ILLS, LACK, LESS, LOOK, LOVE, MIND, NEED, RISK, ROAD, SAKE, TAKE, TEND, UNIT, WANT, WARY
CARL: MARX
CARS: BELT, BUGS, CITY, COPS, ENVY, FAST, FEAR, FORD, FUME, HIRE, JACK, JAMB, NONE, PARK, RACE, ROAD, TOYS, UNTO, USED, VANS, WELD
CART: DUNG, DUST, LOAD, MUCK, RAGS, RIDE, SECT, TART, TIPS, TREK
CASE: BAGS, BEER, BOOK, CASE, DEAL, FILE, FOOD, LENS, LEST, LIST, NOTE, NOUN, OPEN, RACK, RIBS, SHOW, SUCH, SUIT, TEST, TOOL, WINE, WORK
CASH: BANK, CENT, COIN, DEBT, DONE, FARE, FLOW, FUND, HAND, LACK, LASH, LOOT, LOSE, MASH, MORE, PAID, QUID, SASH, SORT, TILL, VOID
CASK: TUBE
CAST: AWAY, BUST, DUNG, FATE, FISH, HOOK, IRON, LINE, LIST, LOTS, MELT, NEWS, OKAY, PAST, PLAY, RACE, SECT, SHOW, SLOE, TYPE, WORM
CATS: ARCH, DOGS, EYES, HOME, KIND, MATS, MICE, NINE, PAWS, PETS, PIGS, RATS
CAVE: ALAN, BATS, CLUB, COLD, COVE, DANK, DARK, ECHO, EERY, HIDE, HILL, HOLE, LAIR, OGRE, OPEN, ROCK
CELL: BODY, DARK, DOCK, GAOL, HELL, HIDE, JAIL, LEAD, LOCK, MATE, MONK, ROOM, UNIT, WALL
CENT: BENT, CASH, COIN, DIME, LADY, NONE, WONG
CHAM: BABY, JEEP
CHAP: ARMY, BEEF, BOYS, CHOP, COLD, COVE, DOOR, GIRL, GOOD, GRAY, HEAD, LIPS, MALE, MIKE, NICE, PAIN, PILL, SORE, THAT
CHAR: BURN, COOK, FIRE, LADY, LAZY, MAID, MOPS, SEAT, SOOT, WORK
CHAT: AWAY, CHIT, COSY, COZY, CRIB, GIRL, IDLE, KNEW, LOUD, TALK, TALL, WITH
CHEF: BEEF, BEST, COOK, FOOD, GOOD, HASH, MEAL, SOUP, WOOD, WORK
CHER: DEAR
CHEW: BITE, DIET, FOOD, FRET, GUMS, LICK, MEAT, MINT, NUTS, SPIT, SUCK
CHEZ: HERE, HOME, LOST, NAME, NOUS, VOUS, WITH
CHIC: DOLL
CHIN: BODY, BONE, CHOP, FACE, GRIN, HURT, NECK, NOSE, PINK, REST
CHIP: CHOP, HACK, MONK
CHIT: CHAT
CHOP: BEEF, CHAP, CHIN, CHIP, CHOP, EDIT, FELL, FOOD, HACK, JUDO, LAMB, LAMP, MEAT, MOCK, PORK, RICE, SHOP, SLAY, SUET, SUEY, WOOD
CHOW: TRIO
CHUM: GLUM, GUMS, MATE, PLUM
CIGS: FAGS, FIGS
CITY: BANK, BOSS, BRUM, CARS, DOME, GENT, HUGE, NEAR, NEON, PLAN, ROAD, ROME, SMOG, TALE, TEAM, TOWN, WISE, YORK
CLAD: SHOD
CLAM: BAKE, YARN
CLAN: SECT
CLAP: BANG, CLIP, CURE, DRUM, FLAP, SLAB
CLAW: BEAK, CRAB, FANG, HOOF
CLAY: FEET, GREY, KILN, LIMY, LUMP, MOLD, MUGS, PIPE, PLAY, POTS, SAND, SOFT, SOIL
CLIP: BELT, BOOK, CLAP, CLOP, CROP, CUFF, EARS, FILE, FILM, HAIR, HAND, HOOK, HURT, LAMB, SHIP, SNIP, STUD, TREE
CLOD: SHOD
CLOG: SNOG
CLOP: CLIP, HOOF, TROT
CLOT: BLOT, BLOW, DAMN, FOOL, LUMP, TWIT, WHAT
CLUB: ACES, ARTS, AXIS, BARN, BEER, BOAT, CARD, CAVE, COSH, DISC, DIVE, FILM, FOLK, FOOT, GLEE, GOLF, HALL, JAZZ, JOIN, MALE, PLAY, PONY, ROOM, ROOT, SAIL, TEAM
CLUE: CODE, FIND, GAME, GLUE, GOAL, HELP, HINT, HUNT, IDEA, LEAD, LEVI, LINK, SPOT, WORD
COAL: BAGS, BURN, COKE, COLE, DIRT, DUMP, DUST, FACE, FIRE, FIVE, FOAL, FUEL, HEAP, HEAT, IRON, LAIR, LIFE, LIVE, LOAD, LOGS, LUMP, MINE, MINK, PITT, POKE, SACK, SEAM, SHED, SKIP, SLAB, SMUT, SOOT, TASK, TIPS, TONG, WOOD, YARD
COAT: AMOK, ARMS, BACK, CAPE, COAT, DRAB, FIRS, FOAL, GARB, GOWN, HAIR, HANG, HARE, HOOD, HOOK, LOSE, MAIL, MANE, MINK, OILY, OVER, RACK, ROBE, SHOD, SIZE, SLIP, SNOW, SUIT, TAIL, TALL, TORE, VEST, WARM, WOOL, WRAP
COCK: BULL, CROW, KNOB, SUCK, WILT
CODE: CLUE
COIF: COIL, COLD, HAIR, HEAD, NICE, NUFF, RING, WHAT
COIL: COIF, FOIL, HOLD, HOOP, LOOP, PILL, RING, ROOT, ROPE, SHIP, WIND, WIRE
COIN: BENT, CASH, CENT, DIME, DISC, DROP, FLIP, GELD, GOLD, HEAD, JOIN, MINT, MIRE, NAIL, OVER, RICH, SLOT, SPIN, TOOL, TOSS, TYPE
COKE: BURN, BURP, CANS, COAL, COLA, COLD, COLE, COOL, FIRE, FIZZ, FUEL, OVEN
COLA: COKE
COLD: AIRY, ARID, BATH, BEEF, BLOW, BOLD, CAVE, CHAP, COIF, COKE, COOK, COOL, CURE, CUTS, DAMP, DANK, DARK, DEEP, DIGS, DIVE, DOSE, DRIP, EERY, FEAR, FEET, FLUE, GRAY, HAIL, HATE, HAZE, HEAD, HEAT, HELL, ILLS, LINO, MILD, MILK, NEAT, NESS, NOSE, NUDE, POLE, RAIN, ROOM, SEAT, SLAB, SNOW, SOLD, SORE, SOUP, SURE, TALL, TAPS, TENT, TOAD, VERY, WALK, WARM, WIND, WRAP, ZERO
COLE: CANE, COAL, COKE, COZY, DIRT, HILL, HOLE, KING, MASS, MINE, SHOP, SLAW
COLT: FOAL, MARE
COMA: DEAD, DEEP, DUNE, HEAD, LONG, PETE, PISS, STOP, TOES
COMB: BENT, HAIR, RAKE, WOOL
COME: ANEW, AWAY, BACK, CALL, CAME, DONE, EASY, FROM, GIVE, GONE, HERE, HOME, NEAR, NEST, OVER, SOME, SOON, UNTO, WENT, WILL
CONE: APEX, AWAY, AXIS, BONE, BULB, CUBE, FACE, FAIR, FIRS, FORK, MILK, NOSE, PINE, REED, RODS, TREE, WOOD
COOK: BAKE, BOIL, BOOK, BURY, CAKE, CHAR, CHEF, COLD, EGGS, FARM, FISH, FOOD, LARD, MAID, MEAL, MEAT, OVEN, PANS, PAUL, RICE, STEW, WASH
COOL: AIRY, BEAT, CALM, COKE, COLD, DAWN, DEEP, DOWN, FOOL, HAND, HARD, JERK, KEEP, KEPT, LAKE, LONG, LUKE, MILK, RAIN, REAL, SKIN, SWIM, TOOL, WARM
COON: BIRD, BOOM, FOOL, GOON, HAIR, MOON, NUTS, SKIN, TAIL, WOGS
COOP: HENS
COOT: BALD, DOVE, MOOT
COPE: FEND
COPS: CARS, FUZZ, MOPS, PIGS, WOOD
COPY: BOOK, CRIB, DATE, DOZE, EASY, EDIT, FAKE, MARK, MIME, TYPE
CORD: BELT, LACE, LASH, LIKE, LONG, LOST, PULL, ROPE, SASH, WAIN, WHIP, WING, WIRE
CORE: BASE, FEND, HATE, IRON, NOSE, OATH, PEAR, PEEL, ROAR, ROOT
CORK: BANK, BLOB, BUNG, PLUG, WICK, WINE, WINS
CORN: BALE, BEEF, CROP, EARS, FEET, FOOD, FOOT, HOPS, JOKE, KANE, LEAD, LOGS, MALT, MANE, MAZE, MAZY, MEAL, MILL, OATS, PITT, POPS, REAP, RIPE, SEED, SILO, SWAY, WALL
COSH: BANK, BASH, BIFF, BLOW, CLUB, FUZZ, GANG, GASH, HEAD, HOSE, HURT, LUMP, MASK, SAND, SINK, STAB, THUG
COST: BILL, BOOK, DEAR, FARE, FREE, HARD, HIGH, LIVE, MOST, SUMS, TAXI, WHAT
COSY: BEAR, CHAT, FARM, FIRE, HOME, NOOK, ROOM, SNOG, SNUG, WARM, WOMB, WOOL, WRAP
COTE: DOVE
COUP: BLOW, HENS, LOCK, RUSH, SECT, STOP, TAKE, TILT
COVE: BOAT, CAMP, CAVE, CHAP, DOVE, HOLE, HOPE, LOVE, NICE, ROCK, SAND
COWL: HOOD, MIKE
COWS: BAGS, BARN, BEEF, DUNG, EYES, FARM, GRAB, HENS, HERD, HERO, HOME, MAID, MILK, PIGS, SILO, SOWS, YARD
COZY: CHAT, COLE, DOZY, FINE, FIRE, FIVE, HOME, LONG, LOVE, NEST, NICE, NOOK, ROOM, SEAT, SMUG, SNUG, SOFA, VERY, WARM
CRAB: CLAW, CRAP, CRIB, DRAB, FEET, FISH, FOOD, FROG, GRAB, LICE, MEAT, NAIL, SLAB, STAB, TREE, WALK
CRAG: ARMY, EDGE, HEAD, HIGH, HILL, MOOR, NOOK, PEAK, ROCK, SCAR, SNAG, TALL, TREE
CRAM: UNIT
CRAP: BURP, CRAB, CRAP, DICE, DIRT, FOOD, GAME, HOLD, LAST, RUDE, SEER, SHIT, SNAP, THIS, TORY, TRAP, WHEN, YEAH
CREW: BOAT, LACY, PULL, ROPE, SHIP
CRIB: BABY, CAGE, CHAT, COPY, CRAB, EXAM, MEAN, ROCK, SHOW
CROP: CLIP, CORN, DROP, DUNG, FARM, GROW, HAIR, HEAD, KALE, NECK, OATS, PICK, RAIN, ROOT, SEED
CROW: BARS, BIRD, BOWL, BRAG, BUNT, COCK, DAWN, FEET, HOOD, KITE, MAST, NEST, PROW, ROOK, ROOM, SHOW, WALL
CRUM: BRUM
CUBA: CUBE
CUBE: BATH, BEEF, BEND, CONE, CUBA, DICE, INCH, ROOM, ROOT, SALT, SIDE, TEST, TUBE
CUBS: BEAR, BOYS, FOWL, LION, PACK, PAWS, PUPS, WILD, WOLF
CUFF: BERT, BLOW, BRAT, CLIP, FIST, HAND, HUFF, LING, LINK, NOSE, STUD
CULT: CANT, SECT
CUNT: ARSE, BUNT, CANT, FUCK, HUNT, PINK, SHIT, SUES, THIS, WARM
CUPS: HICK, PANS, POTS, TEAS, TRAY
CURB: KERB
CURD: TART
CURE: ACNE, CLAP, COLD, DRUG, GOOD, HAMS, HARM, HEAD, HEAL, HOPE, KILL, MEAL, MEND, PAIN, PURE, REST, SAVE, SICK, SINE, TEST
CURL: GIRL, HOOK, MOTH, WAVE, WOOL
CURT: KEEN
CUSS: OATH
CUTE: NICE
CUTS: BACK, BURN, COLD, DEEP, DOWN, FILM, HURT, MEAT, OUCH, PAIN, REDS, TAPS
CYST: BLAB, BOIL, BUMP, FOOT, HARD, HURT, KNEE, LUMP, NONE, PIST, PUSS, SCAB, SKIN, SORE, SPOT, WART
DADA: DATA
DAFT: ACTS, DOZY, DUCK, DULL, FOOL, GOAT, HEAD, IDEA, LAZY, LOON, PRAY, RAFT, SOFT, TWIT, WHAT
DALE: BEST, DELL, DOWN, FARM, GLEN, HILL, KENT, KIRK, LAND, MONK, MOOR, PEAK, TEAS, VALE, WALK, WOOD
DAME: AUNT, DAMN, GALL, GIRL, LADY, LORD, MAID, NAME, PAWN, RUTH, SARK, WELL
DAMN: BELL, BLOW, CLOT, DAME, DARN, DUMB, EDAM, FOOL, GOOD, HECK, HELL, MILD, NONE, OATH, SIRE, SOME, WEAK, WOGS, WORD
DAMP: COLD, DANK, DARK, FIRE, MIST, MOSS, MUST, RAIN, ROOM, SEEP, TENT, WALL
DANG: DONG, RANG
DANK: BANK, BEER, CAVE, COLD, DAMP, DARK, DINK, GRIM, HAIR, LANK, MOSS, RANK, TANK, WARM, WHAT, WORK
DARE: BARE, BELL, BOLD, DEED, FAIR, GRIM, JEST, KILL, PITY, RISK, SAFE, TASK, WILL
DARK: AGES, ALLY, BATS, BIND, BLUE, BODY, BROW, CAVE, CELL, COLD, DAMP, DANK, DARK, DAZE, DEAF, DEEP, DIRT, DOOM, DULL, EERY, EVIL, FACE, FAIR, FEAR, FILM, FINE, GAOL, GLOW, GRAY, GRIM, HOLE, KNOW, LAMP, LANE, LEAP, MALE, MOLE, MOTH, NIGH, PALE, PROW, ROOM, SHED, SHOT, SLOW, SMOG, SNOG, SUIT, TALL, VOID, WARM, WARY, WOOD
DARN: DAMN, DRAT, FOOL, GONE, GOOD, GOSH, HOLE, JOHN, KNIT, MEND, SAVE, SOCK, SPIN, THAT, WOOL, YARN
DART: BEER, DASH, FART, FEEL, FORD, GAME, HERE, JUMP, LINE, MOOR, RUSH
DASH: DART, FAST, FLIT, JACK, LINE, RACE, RASH, RUSH, SLIP
DATA: DADA, DUMP, FACT, FORM, MATE
DATE: BIND, BIRD, COPY, FIGS, GIRL, HATE, HOUR, JUNE, KEPT, LATE, LINE, PALM, PATE, SAGA, TIME, WHEN, YEAR
DAVE: ALAN, BEAK, BERG, DOZY, RAVE
DAWN: COOL, CROW, DUSK, GIRL, HAIL, HUSH, MICE, MORN, PINK, ROSY, RUSH, VALE
DAYS: AGES, ANEW, FIVE, GONE, LAST, LEES, LIFE, LONG, OURS, PAST, TOIL, WEEK, WORK, YEAR
DAZE: BLOW, BLUR, DARK, DOZE, DRUG, GAZE, HAZE, HAZY, HEAT, LOST, MAZE, RAVE, ROLL, SWIM
DEAD: AGED, BANG, BEAT, BODY, BOMB, BORE, BORN, COMA, DEAN, DEED, DIED, DIET, DOOM, DRAB, DROP, DUCK, DUST, ENDS, EVIL, FALL, FELL, GONE, GOOD, GREW, GUNS, HALF, HANG, HARD, HERO, JUMP, KEEN, KILL, LIES, LIFE, LIMP, LINE, LIVE, LOSS, MANY, MASS, MOOT, NAIL, PORK, PURE, RICH, RUIN, SHOT, SICK, SLAY, SLUG, STOP, SURE, TAME, TIRE, TOMB, UPON, WEED, WILL, WILT
DEAF: BIND, DARK, DUMB, DUMP, EARS, HARD, HEAR, HOME, MUTE, ORAL, POST, TONE, WHAT
DEAL: CARD, CASE, DICE, EMIT, FAIR, GIVE, GOOD, HAND, HARD, KENT, PACK, PEAL, PLAY, PORT, QUID, SEAM, WITH, WOOD
DEAN: ARTS, BOSS, DEAD, DICK, HEAD, POMP
DEAR: AUNT, CHER, COST, DICK, DOES, FARE, GIRL, HART, JOHN, LADY, LIZA, LOVE, NEAR, ONES, RAIN
DEBT: BANK, BILL, CASH, DUTY, LOAN, LOSS, OWED, OWES, PAID
DECK: BOAT, CARD, FORE, HAIR, HAND, PACK, PECK, POOP, SHIP, SLIP, TAPE, WEAR
DEED: BOLD, DARE, DEAD, DIED, DIRE, DOER, DONE, DUTY, FACT, FEAT, FOUL, GIFT, GOOD, POLL, SAID, SEAL, TASK, WILL, WORD, WORK
DEEP: AVON, BLUE, COLD, COMA, COOL, CUTS, DARK, DELL, DIGS, DIVE, DOWN, GASH, GULF, HIGH, HOLE, KNEE, LAKE, LOCH, LOVE, PITT, POND, POOL, ROOT, SEAS, SEEP, SINK, SKIN, TUBA, VALE, WEEP, WELL, WIDE
DEER: BARK, BEER, BUCK, DOER, FAWN, FORM, GAME, GOAT, HART, HIND, HUNT, JANE, LOPE, MARE, MEAT, ONYX, PARK, SEER, STAG, SWAN, VEAL, WOOD
DEFY: DENY
DELL: BELL, DALE, DEEP, DOLL, DOWN, GLEN, HELL, HILL, HOLE, KAHN, NOOK, QUAY, VALE, WELL, WOOD
DEMI: HALF, PART, SEMI, WAVE
DEMO: ANTI
DENT: BALD, BASH
DENY: DEFY, HELP, LIAR, OMIT, STOP, TELL
DESK: BELL, BOOK, BOSS, DISK, EXAM, LAMP, LEAN, MAIL, MESS, SEAT, SITS, TIDY, WOOD, WORK
DICE: ACES, CARD, CRAP, CUBE, DEAL, DOTS, FIVE, GAME, LICE, LUCK, LUDO, NICE, ODDS, PLAY, SPOT, TOSS, VICE
DICK: DEAN, DEAR, DOZY, MICK, POSH, WICK
DIED: AWAY, BLUE, BORN, DEAD, DEED, FEAR, GONE, GOOD, HERO, WEPT
DIES: LIES, TAPS
DIET: CHEW, DEAD, FOOD, GOOD, MEAL, MEAT, MILK, NUTS, SCUM, SLIM, THIN
DIGS: COLD, DEEP, DIRT, FLAT, FOOD, FOWL, HALL, HOLE, HOME, JOHN, LIVE, PAIN, ROAD, ROOM
DIKE: BANK, DOVE, GREY, HIKE, HOLE, MIKE, MOLE, PIKE, SILL, WALL, WHAT, WIND
DIME: BELL, BLUR, CENT, COIN, POOR, RUBY, TIME, YANK
DINE: DONG, WINE
DING: BELL, DING, DONG, DUNG, GONG, LING, PING, RING, TILL, WONG
DINK: DANK
DIRE: DEED
DIRT: BASE, BATH, BOIL, BOYS, BUGS, COAL, COLE, CRAP, DARK, DIGS, DOGS, DUNG, DUST, EARS, FALL, FLUE, FOOT, GNAT, GRIT, HEAP, HOME, KIDS, LICE, LINO, MESS, MICE, MIND, MIRE, MUCK, PIGS, PILE, RAGS, RATS, RUST, SCUM, SHIT, SMOG, SMUT, SOAP, SOIL, SOOT, SPOT, TOWN, WASH, WIPE
DISC: BLUE, BUSH, CLUB, COIN, DISK, DRUM, FLIP, PLAY, ROCK, SLIP, SOUL, SPIN, TURN
DISH: AJAR, BIRD, BOWL, BRAN, DOLL, FISH, FOOD, GIRL, MEAT, MEET, MILK, MOPS, OVEN, PANS, SOAP, SOUP, TART, THEM, TRAY, WARE, WASH, WISH
DISK: DESK, DISC, DOWN, PUCK, RING, SLIM, TAPE
DIVE: AWAY, BOMB, CLUB, COLD, DEEP, DOWN, DUMP, FALL, FROG, HIGH, HOLE, JIVE, JUMP, POOL, SINK, SWIM
DOCK: BOAT, CELL, DUCK, HICK, JURY, LADY, LAND, LEAF, PORT, SHIP, SIDE, YARD
DOER: BUSY, DEED, DEER, DOES, DONE, DOUR, DULL, EVIL, FUSS, GOER, GOOD, GULL, LAZY, SEER, WHAT, WORD, WORK
DOES: ACTS, CALL, DEAR, DOER, FINE, FITS, GOES, GOOD, LIVE, MAKE, WHAT, WHOM, WORK
DOGS: BARK, BIRD, BITE, BRED, CATS, DIRT, EATS, FARM, HAIR, HARE, HUNT, ISLE, LEAD, LIFE, MESS, OURS, PAWS, PETS, PIGS, RATS, SHIT, TAME, WOGS
DOLE: SACK
DOLL: BABE, BABY, BIRD, CHIC, DELL, DISH, FACE, GIRL, HAIR, HANG, HELL, LOLL, LOST, MADE, PEGS, PLAY, PRAM, RAGS, TALK, TOYS
DOME: ARCH, BEAK, BELL, BONE, CITY, HALL, HEAD, HIGH, PAUL, ROCK, ROME, ROOF, STAR
DONE: BEEN, CASH, COME, DEED, DOER, DUTY, GAVE, GIVE, GONE, HARM, HAVE, JOHN, LAST, MADE, OVER, PAID, PAST, RUNG, SAID, THEN, TURN, USED, WELL, WHAT, WITH, WORK
DONG: BELL, DANG, DINE, DING, DUNG, GONG, PONG
DOOM: BOMB, BOOK, BOOM, DARK, DEAD, FALL, FATE, HELL, MEET, RUIN
DOOR: AJAR, ARCH, BACK, BANG, BARN, BELL, CAGE, CHAP, EXIT, FLAP, GATE, HALL, HEAT, HIGH, HOLE, HOME, HOOK, INTO, JAMB, KEEP, KEYS, KNOB, LIFT, LOCK, MOOR, NAIL, NEXT, OPEN, OVEN, POST, PULL, PUSH, RANG, REAR, RING, ROOM, SEEM, SEER, SHUT, SIDE, SNUB, STEP, STOP, TRAP, WOLF, WOOD
DOPE: LOPE
DOSE: COLD, DRUG, GIVE, HORN, NOSE, OVER, PILL
DOTS: DICE, LINE
DOUR: DOER, GLUM
DOVE: BIRD, COOT, COTE, COVE, DIKE, GREY, HAWK, LOVE, NOAH, RING, TAIL, TREE, WING
DOWN: BEAR, BEAT, BEND, BLEW, BLOW, BORE, BOWS, COOL, CUTS, DALE, DEEP, DELL, DISK, DIVE, DROP, DUCK, DUMP, ENVY, EYES, FALL, FELL, FLAG, FLOW, GOES, GONG, GULP, HANG, HELD, HELL, HILL, HOOF, HOSE, JUMP, KEEP, KEPT, KNOB, LAID, LANE, LEAN, LEAP, LIES, LIFT, LOOK, MARK, MINE, NAIL, NOTE, PULL, RACK, RAIN, RING, ROLL, RULE, SANK, SATE, SEEP, SENT, SHOT, SHOW, SHUT, SIGH, SINK, SITS, SLIP, SLOE, SLOW, SNOW, SOFT, SPIN, STAY, STEP, SWAN, TAKE, TALK, TEAR, TIED, TIES, TOMB, TORE, TOWN, WALK, WASH, WEAR, WENT
DOZE: BULL, COPY, DAZE, LAZY, REST, ROSE, SEEP
DOZY: COZY, DAFT, DAVE, DICK, DUCK, FRED, LAZY, TWAT
DRAB: COAT, CRAB, DEAD, DRAG, DRIB, DRIP, DULL, FLAB, GARB, GRAY, GREY, ROOM
DRAG: BACK, BIND, BORE, CAMP, DRAB, DRAW, DULL, EXAM, HAUL, HELL, HOME, HYMN, LIFE, LIFT, LIMP, OBEY, POEM, PULL, RACE, ROPE, SHOW, SLUR, SWAG, TIME, WEEK, WHAT
DRAM: GILL
DRAT: DARN
DRAW: AWAY, BACK, DRAG, FORM, FROM, GOAL, KNOB, LIKE, LINE, LOTS, LUCK, NUDE, PULL, SUCK
DRIB: DRAB
DRIP: BATH, BLOB, BORE, BRIM, COLD, DRAB, DROP, FEED, FLOW, GLUE, LASS, LEAK, NOSE, PLOP, POOR, POUR, RAIN, SEEP, SLOB, TAPS, WEED
DROP: ACID, BALL, BOMB, BUMP, COIN, CROP, DEAD, DOWN, DRIP, DUMP, FALL, FELL, FOOD, HANG, HOLD, JOIN, LIFT, LIME, LOSE, NOSE, OOPS, PART, PASS, PEAR, PICK, RAIN, SHED, SLIP, SNOW, SOAR, SPOT, STOP, TEAR, THEM
DRUG: ACID, CURE, DAZE, DOSE, HARD, HASH, HEAL, HELP, HEMP, LOVE, PAIN, PILL, POTS, RAID, STUN, TAKE, TRIP, WEED
DRUM: BAND, BANG, BASE, BEAT, BEET, BOOM, BRUM, CLAP, DISC, EARS, FIFE, JAMB, JAZZ, JIVE, PIPE, ROLL, SIDE, SING, SOLO
DUCK: BACK, BEAK, BILL, BIRD, DAFT, DEAD, DOCK, DOWN, DOZY, DUCK, FOWL, FUCK, HARE, HENS, HONK, JERK, LAME, LING, LUCK, MISS, MUCK, POND, SOUP, SUCK, SWAN, SWIM, TEAK, UGLY, WILD, ZERO
DUCT: BILE
DUDE: GENT
DUET: SUET, TRIO
DUFF: PLUM, PUFF, SUET
DUKE: EARL, PEER, POLO, PUKE, YORK
DULL: ACHE, BORE, DAFT, DARK, DOER, DRAB, DRAG, DUST, FINE, GAME, GRAY, GREY, GRIM, LAZY, LEAD, LIVE, POEM, POSH, RAIN, RATE, SANE, SLOW, THIS, THUD, WORK
DUMB: BELL, DAMN, DEAF, FACE, FOOL, GLUM, LIPS, MIME, MOOT, MUTE, PITY, TALK
DUMP: BOMB, COAL, DATA, DEAF, DIVE, DOWN, DROP, FUEL, HEAP, HOLE, LUMP, MESS, MUCK, PUMP, SITE, SLAG, TIPS
DUNE: COMA, HILL, SAND
DUNG: ANTS, BELL, CART, CAST, COWS, CROP, DING, DIRT, DONG, FARM, HEAP, LEAF, LEAP, MESS, MIRE, MUCK, PIGS, PILE, SHIT, WONG
DUSK: DAWN
DUST: ANTS, ATOM, BITE, BITS, BOWL, BULL, CART, COAL, DEAD, DIRT, DULL, EYES, FLUE, FURY, GOLD, HEAT, JEEP, LIDS, MARS, MOON, MOTH, PANS, ROAD, SAND, SMUT, SOOT, SPOT, STAR, TRAP, WORK
DUTY: ARMY, BOND, BORE, DEBT, DEED, DONE, FREE, HARD, MUST, NEED, NONE, OBEY, ONUS, SELF, SICK, TASK
EACH: BOTH, KIND, PART, TIME
EARL: DUKE, GREY, KING, LORD, MALE, PEER, RICH, TILE
EARN: KEEP, LOOT, MAKE, PAID, SAVE, SPIT, WAGE, WHAT, WORD, WORK
EARS: BATS, BITE, BOTH, CLIP, CORN, DEAF, DIRT, DRUM, EYES, FACE, FLAP, GRIN, HAIR, HARE, HEAR, HURT, LOBE, NOSE, NOSY, PLUG, WASH
EASE: CALM, EASY, EDGE, GAIN, GIRL, HARD, HELP, LEST, LIFE, NICE, PAIN, REST, SHOE, SLIP, STOP, WITH, WORK
EAST: EDEN, FIFE, GURU, NEAR, NEST, SARI, WEST, WIND
EASY: ARTS, BEAT, CALM, COME, COPY, EASE, EASY, EXAM, FEAR, FLOW, FREE, GIFT, GONE, GOOD, HARD, LAZY, LIFE, LIVE, MADE, MEAN, NICE, PATH, SEEM, SOFT, TALK, TASK, TIRE, WARY, WINK, WORK
EATS: BURP, CAKE, DOGS, FATS, FIGS, FOOD, FULL, MEAL, MEAT, MUCH, NICE, OATS, PIGS, RATS, TEAS, WITS
EBBW: VALE
ECHO: BACK, CAVE, ECHO, HALL, HEAR, MYTH, RING, ROCK
EDAM: ADAM, DAMN, FIRM, MEAD, NAME, PEAR, SELL, VALE
EDEN: EAST, MARK, PARK, PITT, VALE
EDGE: APEX, BRIM, CRAG, EASE, EDGY, FALL, FRAY, HILL, KEEN, KERB, LANE, NAIL, SIDE, SILL, THIN, TRIM, WAYS
EDGY: EDGE, WARY
EDIT: ALAN, BOOK, CHOP, COPY, PASS, READ, TAPE, WORD, WORK
EERY: BATS, BIRD, CAVE, COLD, DARK, LAKE
EGGS: ANTS, BIRD, CAKE, COOK, EXIT, FARM, FOOD, FOWL, GOOD, GUTS, HAMS, HENS, LAID, LARD, LIFE, LION, MILK, NEST, NOGS, NUTS, SAFE, SUCK, TRAY, YOLK
ELMS: FIRS, HATS, LAKE, LANE, NINE, OAKS, ROAD, TREE, WAVE, WOOD
ELSA: ELSE, MAID
ELSE: ALSO, AUNT, ELSA, GLAD, NONE, SELF, TOUR, WHAT, WISE
EMIT: DEAL
EMMA: PEEL
ENDS: BOOK, BOTH, DEAD, ENDS, FAGS, HERE, LANE, MEET, ODDS, ROAD, ROPE, TIED, TIPS, WELL, WITS
ENVY: CARS, DOWN, HATE, HAVE, LIKE, LOVE, LUST, NONE
EPEE: FOIL
EPIC: POEM, SAGA
ERAS: AGES
ERGO: EROS, LAKE, ONCE, THUS, WHAT, WORK
ERIC: GILL, IDLE
EROS: ERGO
ESSO: BLUE, PUMP, SIGN
ETON: FAGS, WALL
EVEN: ACHE, ADAM, ALSO, FLAT, GOOD, LESS, LEST, LOSS, MALE, MOST, NINE, ODDS, PACE, SAME, THAN, THEN, TIME, WERE, WHEN
EVER: ABLE, ALSO, AMEN, ANON, BACK, BEEN, BEST, CANT, EVER, GONE, LAST, MORE, MOVE, NICE, ONLY, SURE, THAN, THUS, TILL, UNTO, VERY, WHAT, WHEN
EVIL: ACES, BASE, DARK, DEAD, DOER, FATE, FILM, FOUL, GOOD, HARM, HATE, HOLY, ILLS, LEER, LIFE, MIND, NAZI, PEST, PURE, ROOT, SINS, VALE, VICE, WARS, WARY, WEED, WISE
EWES: EYES, HORN, LAMB, RAMS, ROOF, WOOL
EXAM: BORE, CRIB, DESK, DRAG, EASY, FAIL, FEAR, HARD, HELL, JUNE, LIST, MARK, MOCK, ORAL, PASS, ROOM, SITS, SOON, SWOT, TEST, TIME, VIVA, WORK
EXIT: DOOR, EGGS, FIRE, GANG, GONE, INTO, LEFT, ONLY, OPEN
EYED: HAWK, SLOE, WIDE, WILD
EYES: ATOM, BAGS, BALL, BATS, BLUE, CATS, COWS, DOWN, DUST, EARS, EWES, FACE, FROG, GAZE, GRAY, HAWK, HAZE, HEAD, HURT, IRIS, LEER, LENS, LIDS, NECK, NOSE, OPEN, PAIR, PAST, PITY, SEAL, SEEN, SEER, SHUT, SITE, SLOE, SORE, TART, TEAR, WINK, WOOL, YOUR
FACE: ACNE, AGED, BABE, BABY, BARE, BODY, CHIN, COAL, CONE, DARK, DOLL, DUMB, EARS, EYES, FACT, FAIR, FIST, FULL, GASP, GLUM, GOSH, GRIM, GRIN, HAIR, HEAD, LEER, LESS, LIFT, LIPS, LOOK, MARY, MASK, MOLE, NECK, NOSE, NOSY, PACE, PACK, PALE, PIES, POSE, PULL, PUSS, RASH, ROCK, ROSE, SAME, SAVE, SCAR, SHAM, SKIN, SOAP, SOFT, SPOT, TURN, TWIT, TYPE, UGLY, VAIN, WASH
FACT: DATA, DEED, FACE, FATE, FEET, FIND, IDEA, KNEW, KNOW, LESS, LIFE, NEWS, SUCH, THAT, TRUE, WHAT
FADE: GAZE, SIGH, WANE, WILT
FAGS: BEER, BOYS, CIGS, ENDS, ETON, LEAF, LUNG, PUSH, TIPS
FAIL: BARN, EXAM, FALL, FLOP, HAIL, LIST, LOSE, MAIL, MISS, PASS, RATE, SAFE, SIGN, STOP, TEST, WORK
FAIR: ACES, BEAR, CONE, DARE, DARK, DEAL, FACE, FETE, FINE, FOUL, FOWL, GALA, GAME, GIRL, GOOD, HAIR, HOOP, ISLE, JUST, LADY, LUCK, MAID, NEAR, PLAY, ROSE, SHOW, SKIN, TOWN, UGLY, WARE, WIND
FAKE: BAKE, CARD, COPY, FOOL, FRAY, HERO, LIES, LOOK, MASK, MOCK, RAKE, REAL, RISK, SAKE, SHAM, TAKE, WELL, YANK
FALL: BALL, BASH, BRIM, BUMP, DEAD, DIRT, DIVE, DOOM, DOWN, DROP, EDGE, FAIL, FAST, FATE, FEAR, FLIP, FOIL, FOLD, FREE, FROM, GLEE, HOLE, HURT, JUDO, JUMP, LEAN, LEAP, OOPS, OUCH, PAIN, PASS, PILE, PITT, PLAY, POND, PUSH, RAIN, RATE, REEL, RIBS, RIDE, RISE, ROCK, ROLL, RUIN, RUSH, SEER, SINK, SLIP, SNOW, SOAR, SWAY, TRIP, VOID, WALK, WANE, WELL
FAME: FANG, GAME, HALL, HERO, MINE, NAME, STAR
FANG: BITE, CLAW, FAME, FIRE, TUSK, WOLF
FARE: BILL, CASH, COST, DEAR, FINE, FOOD, FOUL, GAME, HALF, LENT, MAID, SAGA, TAXI, THEE, TOLL, WARE, WELL
FARM: BARN, BRAN, BULL, CALF, CALM, COOK, COSY, COWS, CROP, DALE, DOGS, DUNG, EGGS, FIRS, FOOD, GATE, HAND, HARM, HENS, LAND, LASS, MINK, MUCK, PIGS, SILO, STUD, TEND, WORK, YARD
FART: ANUS, ARSE, BEER, BLEW, BLOW, BOFF, BURP, DART, GASP, HART, HEAT, HUGH, PART, PONG, PUKE, PUMP, RASP, RUDE, SHIT, SLOW, TART, WIND
FAST: CARS, DASH, FALL, FLEE, FLOW, FOLD, FOOD, FUCK, FURY, GOES, GREW, GRIP, HARD, HARE, HOLD, JERK, KEEN, KNOT, LENT, MOVE, OBEY, PACE, RASH, RATE, READ, RUSH, SELL, SLOE, SLOW, SNOW, SURE, SWIM, TALK, TURN, VERY, WALK, WENT, WIND, WORK
FATE: CAST, DOOM, EVIL, FACT, FALL, FEET, FLAT, GODS, HAND, HATE, HELL, HOPE, ILLS, LIFE, LOSS, LUCK, MATE, NUTS, PATE
FATS: EATS
FAWN: DEER, FOAL
FEAR: CALM, CARS, COLD, DARK, DIED, EASY, EXAM, FALL, FEAR, FIRE, FLEE, FRET, FROM, FURY, GANG, GASP, GRIM, GRIP, GULP, HARM, HATE, HELL, HIDE, HOPE, HOWL, LEST, LION, LONE, LOST, LOVE, PAIN, PANG, PITY, RAGE, RAPE, SILK, SKIN, TEST, UGLY, WAGE, WAIL, WARS, WASP, WEAR, WHAT
FEAT: DEED, HILL, NEAT
FEED: BABY, BACK, BIRD, BOWL, DRIP, FOOD, GIVE, GOOD, HENS, KILL, MEAD, MEAT, MIND, NOSH, OATS, PAID, PECK, PIGS, REAR, SEED, TRAY
FEEL: DART, FELT, FINE, FIRM, FREE, GOOD, GRIP, HAND, HEAL, HOLD, HURT, LIKE, PAIN, PITY, SKIN, SOFT, SORE, THIS
FEES: HALL
FEET: ACHE, ARMS, BARE, BATH, BEAR, BEET, BIND, CLAY, COLD, CORN, CRAB, CROW, FACT, FATE, FEET, FETE, FIST, FLAT, FOOT, FOUR, FRET, HAND, HEAD, HIKE, HOOF, LEGS, LIMP, MARY, MINE, MOLE, NINE, PACE, PAWS, PEGS, PIGS, POTS, SHOD, SHOE, SOCK, SOLE, SORE, STEP, TINY, TOES, TOGS, TUBE, WALK, WARM, WIPE, YARD
FELL: AWAY, CHOP, DEAD, DOWN, DROP, FROM, HOWL, HURT, INTO, KNEE, MOOR, OVER, PAIN, SANK, SCAR, SLIP, TELL, TREE, WALK, WOOD, YELL
FELT: FEEL, FINE, GLAD, GOOD, HATS, HURT, LIKE, LONG, NEED, NICE, PAIN, ROOF, SOFT, SORE, TURN, USED
FEND: BOAT, COPE, CORE, FIRE, FIVE, FOOD, FORK, HAIR, HELP, KEEP, LIVE, MEND, PUSH, SAVE, SELF, TEND, TENT, TYRE, WARD
FENS: HENS
FERN: MOSS
FETE: FAIR, FEET, GALA, HATS, HEAT, JUDO, LATE, TENT
FIBS: LIES, SINE
FIFE: DRUM, EAST
FIGS: ADAM, ARAB, BRAN, CIGS, DATE, EATS, FILM, FOOD, LEAF, PIGS, PIPS, ROLL, TREE, WIGS, XMAS
FILE: AWAY, BLUE, BOOK, CARD, CASE, CLIP, FILE, FLAP, FULL, JAIL, LINE, LIST, NAIL, NONE, OPEN, PLAN, POST, RAIL, RANK, RASP, TIDY, TILE, TOOL, WOOD, WORK
FILL: BILL, BRIM, FORM, FULL, HILL, JACK, KILL, LACK, NEED, POUR, SKIP, TIME
FILM: APES, BERG, BLUE, BORE, CLIP, CLUB, CUTS, DARK, EVIL, FIGS, GOOD, HALL, HELP, HILL, KANE, LOOP, MIST, NUDE, PLAY, RANK, REEL, SEEN, SEXY, SHOW, STAR, TEST, THIN, THUG, UNIT
FIND: BALL, CLUE, FACT, FUND, GOLD, HERE, HIDE, HOLD, HUNT, KEEP, LAST, LIFE, LOOK, LOOT, LOSE, LOSS, LOST, ROOT, SEEK, TIME, YEAR
FINE: ARTS, COZY, DARK, DOES, DULL, FAIR, FARE, FEEL, FELT, FOUL, FULL, GOOD, HAIR, HELL, JUST, LACE, LACY, LASS, LOSS, MESH, MOOT, NICE, OWED, PARK, PULP, RAIN, RARE, RICH, SILK, SINE, SOOT, SPIT, SUES, THIN, TIDE, TIME, WELL
FINN: MICK
FINS: RAYS
FIRE: ARMS, AWAY, BALL, BANG, BOMB, BURN, BUSH, CALM, CAMP, CHAR, COAL, COKE, COSY, COZY, DAMP, EXIT, FANG, FEAR, FEND, FIRE, FIST, FLUE, FOAM, FUEL, FUME, FURY, GLOW, GUNS, HEAT, HELL, HIRE, HISS, HOME, HOSE, LOGS, OPEN, OVEN, PANT, PLUG, POKE, PUMP, RISK, ROME, SACK, SIDE, SOFA, SOOT, SPIT, SURE, TENT, TIRE, TOES, TONG, WARM, WICK, WIRE, WOOD, YELL
FIRM: BOND, BRIM, EDAM, FEEL, FOOD, FOOT, GRIP, HAND, HARD, HELD, HOLD, MADE, MIND, RASP, RIPE, SAFE, SOFT, SURE, TITS, TYPE, TYRE
FIRS: COAT, CONE, ELMS, FARM, FURS, LAST, MINK, NINE, PINE, RAIN, TREE, WOOD
FISH: BAIT, BIRD, BOAT, BOIL, BONE, BOWL, BUSY, CAFE, CAKE, CAST, COOK, CRAB, DISH, FLIP, FOOD, FORK, FOUL, FOWL, GILL, GULL, HARE, HOOK, HUNT, JERK, LAKE, LIMY, LINE, LING, LUNG, MANY, MEAL, MEAT, NEWT, PATE, PIER, POND, POOL, RARE, RAYS, REED, REEL, SAGA, SAIL, SEAL, SEAS, SELL, SHIP, SHOP, SINS, SLAB, SLOE, SOLE, SWIM, TANK, TUBA, WIFE, WORM
FIST: BALL, BLOW, BOUT, CUFF, FACE, FEET, FIRE, FULL, GRIP, HAND, IRON, KNOT, LAST
FITS: DOES, GOES, HELP, INTO, NUTS, RAGE, SIZE, SLIM, SUIT, WELL
FITT: WITS
FIVE: COAL, COZY, DAYS, DICE, FEND, FORE, FOUR, GATE, HAND, JIVE, LAKE, NINE, PAST, STAR, TAKE, TOES, UNIT, WAYS, WITS
FIZZ: BANG, BEER, BUZZ, COKE, FUZZ, HIGH, SODA, SSSH
FLAB: DRAB
FLAG: BOAT, BUNT, DOWN, FLAP, HOPE, IRIS, JACK, LAMB, LAMP, MAST, MINE, NAZI, POLE, SHIP, SIGN, SLAB, SWAY, TAPS, TIRE, WAVE, WILT
FLAP: BACK, BLOW, BOOK, CLAP, DOOR, EARS, FILE, FLAG, FLIP, FLOP, FOLD, JACK, LANG, LOBE, OPEN, OVER, PLOP, RAGE, SAIL, SKIN, TAIL, TENT, WAVE, WIND, WING
FLAT: BASH, BORE, DIGS, EVEN, FATE, FEET, FORM, HAIR, HOME, IRON, JOKE, LAND, LEAF, LIES, LOAD, MATE, MINE, NOTE, POND, RENT, ROOF, ROOM, SING, SNUB, SPIN, THIN, TILE, TRAY, TYRE, WALL, WIDE, WORM
FLAX: HEMP, YARN
FLAY: HOLD
FLEA: AWAY, BITE, BODY, FLEA, FLEE, GNAT, ITCH, JUMP, LICE, MITE, PEST, TICK, WALL
FLED: SHED
FLEE: ARMY, AWAY, BITE, FAST, FEAR, FLEA, FLUE, FROM, GNAT, ITCH, JUMP, LAZY, MICE, RACE, STAY, TICK, WASP, WIND, WOOD
FLEW: FLOE, GREW, KITE
FLIP: COIN, DISC, FALL, FISH, FLAP, FLOG, FLOP, HECK, MISS, OVER, SIDE, SPIN, TOSS, TURN, WHIP
FLIT: DASH, MIST, TWIT
FLOB: BLOB
FLOE: ANDY, AWAY, FLEW, FLOW, FLUX, FRED, GIRL, MARY, NAME, PIPE, TIDE, WAVE, WHAT
FLOG: BACK, BEAT, BELT, BENT, FLIP, FROG, GOAT, HARD, HURT, LASH, MOST, NICK, PAIN, PUMP, ROPE, SELL, SHIP, SOLD, WHIP
FLOP: FAIL, FLAP, FLIP, WILT
FLOW: BACK, CASH, DOWN, DRIP, EASY, FAST, FLOE, FLUX, FROM, LEAK, MELT, MILL, PATH, PIPE, PLUG, POUR, PURE, RUSH, SEEP, SLOW, STEM, STOP, SUCK, TIDE, TUBE
FLUE: BEAR, BLUE, BOUT, COLD, DIRT, DUST, FIRE, FLEE, PIPE, SOOT
FLUX: BULB, FLOE, FLOW, IRON, PLUG, VARY, WIRE
FOAL: BABY, CALF, COAL, COAT, COLT, FAWN, FOUL, FOWL, GOAL, HARE, LAMB, LEGS, LOAF, MARE, PLAY, PONY, VEAL
FOAM: BATH, BEER, FIRE, FUZZ, LASH, PROW, ROAM, SAND, SCUM, SOAP, SONG, SUDS, SURF, TIDE, WAVE
FOGS: LOGS, TOGS
FOIL: COIL, EPEE, FALL, FOOL, MESH, ROLL, THIN, TOIL
FOLD: BACK, BAND, BELT, BEND, BILL, BIND, BOLD, FALL, FAST, FLAP, LEAF, LINE, MEND, OVER, PAGE, SHUT, TEAR, TURN
FOLK: BARN, CLUB, JAZZ, LORE, LOVE, MOST, POKE, POOR, RICH, ROCK, SING, SONG
FOND: LIKE
FOOD: BABY, BAIT, BAKE, BARS, BEEF, BITE, BRAN, BRED, BULK, BUNS, BURP, CAFE, CAKE, CANS, CASE, CHEF, CHEW, CHOP, COOK, CORN, CRAB, CRAP, DIET, DIGS, DISH, DROP, EATS, EGGS, FARE, FARM, FAST, FEED, FEND, FIGS, FIRM, FISH, FOWL, FROG, FUEL, GOOD, GROW, GRUB, GULP, GUTS, HAMS, HASH, HENS, HOOF, KITE, LACK, LAMB, LEEK, LEST, LIST, LOOT, LUMP, MEAL, MEAT, MEET, MENU, MESS, MICK, MOOT, MORE, MUCH, NEED, NICE, NOAH, NONE, NOSY, OATS, OVEN, PACK, PANS, PATE, PETS, PIES, PIGS, PILE, PORK, POSH, PRAY, PREY, PUKE, QUID, RICE, RICH, SALT, SATE, SELL, SHOP, SLIM, SOIL, SOUP, STEW, SUET, TART, TAXI, TEAS, THIN, TIME, TOOK, TRAY, WARE, WIFE, WINE
FOOL: BOSS, BRAT, CAKE, CLOT, COOL, COON, DAFT, DAMN, DARN, DUMB, FAKE, FOIL, GOAT, GONE, GULL, HAMS, HEEL, HERO, HICK, HILL, IDLE, JERK, JEST, KNIT, LAIR, LAZY, LIAR, LIES, LOOT, LOPE, MARX, MATE, NOOK, PANT, PEER, PLAY, POPE, PREY, PUKE, PURE, RASH, RISE, RULE, SKIT, SLOB, SNOB, SOME, SUCH, TOOL, TWIT, WISE
FOOT: ARCH, BALL, BARE, BASE, BEST, BOOT, CLUB, CORN, CYST, DIRT, FEET, FIRM, HAND, HEAD, HEAL, HEEL, HOOF, INCH, KERB, KICK, KNEE, LIMB, LIMP, LING, MILE, MOOT, PACE, PATH, PEAS, PINK, POLO, PUMP, ROAD, ROOT, RULE, SHIN, SHOD, SHOE, SIZE, SNUB, SOCK, SOFT, SOLE, SORE, STEP, STUB, TACK, TALE, TOES, TOGS, TRAP, UGLY, UNIT, WALK, YARD
FORD: AVON, CARE, CARS, DART, GLEN
FORE: BACK, BOWS, DECK, FIVE, FOUR, GOLF, HALL, HEAD, HIND, LAND, LOCK, MAST, MOST, REAR, SAKE, SHIP, SKIN, TELL, WARD, WELL, WOLF
FORK: CONE, FEND, FISH, LEFT, LIFT, MEAL, RAKE, ROAD, SOIL, TONG, TURN
FORM: BIRD, BODY, DATA, DEER, DRAW, FILL, FLAT, GOOD, GRIP, HARE, LIST, MAKE, NAME, NOTE, RATE, ROOM, SEAT, SIGN, SOFT, TOTE, TRUE, WORD
FORT: ROCK
FOUL: BEER, BIRD, DEED, EVIL, FAIR, FARE, FINE, FISH, FOAL, GOOD, KNOT, LINE, MESS, NESS, PEST, PLAY, PRAY, SHIT, SMOG, SPIT, SUET, VILE
FOUR: ACES, FEET, FIVE, FORE, FOUR, FREE, GOLF, INCH, LEGS, MARK, MILE, MORE, NOSY, ONLY, PAIN, SIZE, SOAR, SOME, STAR, TAKE, TEEN, TOPS, UNIT
FOWL: BEST, BIRD, CUBS, DIGS, DUCK, EGGS, FAIR, FISH, FOAL, FOOD, GAME, LAMB, PEST, PLAY, SNOB, UGLY, WILD
FRAY: EDGE, FAKE, FROM, INTO, KILL, PUSH, RIOT, ROPE, TEAR, TORN, UPON, WEAR
FRED: ALAN, BERG, DOZY, FLOE, GRAY, NOUN, SEAT, TORE
FREE: AIRY, BIRD, BOLD, BOND, BORN, CARE, COST, DUTY, EASY, FALL, FEEL, FOUR, FREE, FROM, GAVE, GIFT, GOOD, HEAT, HERE, HOBO, HOLD, JAIL, LIFE, LIVE, LOST, LOTH, LOVE, OPEN, PAID, PASS, RENT, ROAM, SALE, SOAR, TIED, TIME, WILD, WILL, WOOD
FRET: CHEW, FEAR, FEET, FUME, HAZE, LOSE, LOVE, PINE, TWIT, WINE, WORK
FROG: CRAB, DIVE, EYES, FLOG, FOOD, GNAT, HEAD, JUMP, LEAP, LEGS, LILY, LUNG, NEWT, POND, POOL, SKIN, TOAD
FROM: AFAR, AWAY, CAME, COME, DRAW, FALL, FEAR, FELL, FLEE, FLOW, FRAY, FREE, HERE, HOME, MADE, MILE, PASS, ROSE, SAVE, SENT, TAKE, TAPS, THEN, TIME, TOOK, WHAT, WITH
FUCK: BOLD, CUNT, DUCK, FAST, FUCK, GIRL, HELL, LOVE, LUST, POKE, POPE, PUCK, RAPE, RIDE, RUDE, SHAG, SHIT, SOON, SUCK, TEEN, TURN, WANE, WIFE
FUEL: BRIM, BURN, COAL, COKE, DUMP, FIRE, FOOD, HEAT, LEAK, NOEL, PEAT, PUMP, TANK, WARM, WOOD
FULL: BACK, BAGS, BALE, BARE, BOWL, BRIM, CARE, EATS, FACE, FILE, FILL, FINE, FIST, GLEE, HALF, HARM, HEAD, HOLE, HURT, LACK, LUST, MIND, MOON, MOST, MUCH, NULL, OPEN, PAID, PAIN, PINT, RIFE, ROOM, SATE, SHOP, SINK, SOLE, SOME, TEAR, TIME, TRAY, TUNE, WILD, WISH
FUME: BLUE, CARS, FIRE, FRET, HUME, PIPE, RAGE, TOIL
FUND: BANK, CASH, FIND, LOST, TRUE
FUNG: LING
FURS: FIRS, POKE
FURY: AWAY, CALM, DUST, FAST, FEAR, FIRE, GALE, HATE, MASK, MUSE, RAGE, WILD, WIND
FUSE: MAIN, WIRE
FUSS: DOER, THEM, THUS
FUZZ: BUZZ, COPS, COSH, FIZZ, FOAM, HAIR, HEAT, LIES, PIGS, RAID
GAIN: AUNT, EASE, HAVE, LOOT, LOSE, LOSS, LOTS, MAKE, MUCH, THEM, TIME, URGE
GALA: BALL, BATH, BUNT, FAIR, FETE, LIDO, MILK, SALE, SHOW, SWIM, WEEK
GALE: BLOW, FURY, GIRL, PASS, RAIN, SEXY, WIND
GALL: BILE, DAME, HAIL
GAME: ARMY, AWAY, BAIT, BALL, BIAS, BIRD, CANS, CARD, CLUE, CRAP, DART, DEER, DICE, DULL, FAIR, FAME, FARE, FOWL, GATE, GOAL, GOLF, HOME, HOOP, IDEA, ITCH, JUDO, LAME, LIKE, LOOP, LOST, LOTS, MANY, MARK, NEST, OVER, PARK, PITT, PLAY, PLOT, QUIZ, RISK, RULE, SAME, SNAP, SORT, STAR, SUMS, TEAM, TOYS, TROT, VICE, WALL, WINK, WORD
GANG: BANG, BOSS, BOYS, COSH, EXIT, FEAR, HAIL, KIDS, LAND, RACE, SHOW, SONG, THUG, TONG, WARY
GAOL: BAIT, BALE, BARS, BIRD, CELL, DARK, GOAL, GOAT, HIBS, JAIL, KICK, NICK, POST, TAIL
GAPE: GASH, GASP, GAZE, YAWN
GAPS: HOPS
GARB: COAT, DRAB, GEAR, GLIB, GRAB, JUNK, NICE, TAKE, TOGS, TOIL, VEST, WEAR
GASH: COSH, DEEP, GAPE, GNAW, HAND, HOLE, KNEE, LASH, PAIN, RASP, SORE, TEAR
GASP: BLOW, FACE, FART, FEAR, GAPE, GULP, GUSH, PAIN, PANT, PUFF, RACE, RAIN, RASP, SIGH, SWAN, WASP, YAWN, YEAH
GATE: ARCH, BARS, BULL, DOOR, FARM, FIVE, GAME, HATE, IRON, KIRK, LOCK, MAIL, OPEN, PARK, PATH, POST, SATE, SHED, SHUT, TRAP, WALK, WALL, WAYS, WELD, WOOD
GAVE: AWAY, BACK, DONE, FREE, GIFT, GIRL, GIVE, GOOD, HAVE, HELP, LENT, LOVE, MARY, RAIN, SAVE, SEND, SENT, TAKE, TOOK, WHAT
GAZE: AWAY, DAZE, EYES, FADE, GAPE, HAZE, LEER, LONG, LOOK, PEER, STAR, UPON, VIEW
GEAR: BIKE, CAMP, GARB, HASH, JUNK, MESH, MODS, SELL
GELD: COIN
GENT: CITY, DUDE, HATS, LADY, LAVS, MALE, SUIT, TOFF
GERM: BUDS, SMUT
GIFT: BOOK, CARD, DEED, EASY, FREE, GAVE, GIVE, HOME, KEEP, KING, NICE, RING, SHOP, WISH
GILD: LILY
GILL: BEER, DRAM, ERIC, FISH, GIRL, JACK, JOHN, LUNG, MILK, PECK, PILL, PINK, PINT, SLIT
GIRL: BABE, BABY, BEDS, BIRD, BLUE, BOOT, BOYS, BUSY, CALL, CHAP, CHAT, CURL, DAME, DATE, DAWN, DEAR, DISH, DOLL, EASE, FAIR, FLOE, FUCK, GALE, GAVE, GILL, GOOD, GRUB, HAIR, HENS, HERS, HIPS, HOOP, IDOL, IRIS, IZZY, JULY, JUNE, KISS, LADY, LANE, LASS, LEGS, LOVE, MAID, MAKE, MARY, MATE, MAZY, MEET, MILL, MISS, MOOD, MOON, MOVE, NAME, NEST, NICE, NOUN, NUDE, PINK, PLUM, PONY, PUSS, RAPE, RATE, SAND, SARI, SEXY, SHOP, SKIP, SLIM, SLIP, SNOB, SNOG, SOAP, SUES, TALL, TART, TWIN, TYPE, UGLY, VAIN, WHAT, WIFE, WILD, YELL
GIRN: SNAP
GIST: TEXT
GIVE: AWAY, BACK, BEST, COME, DEAL, DONE, DOSE, FEED, GAVE, GIFT, HAND, HAVE, KEEP, LEND, LIFE, LIVE, LOAN, LOVE, MAKE, NEED, OVER, ROBE, SAVE, SEND, SHOW, TAKE, UNTO, WHOM
GLAD: ELSE, FELT, HAND, HATE, NEWS, NICE, OPEN, OVER, RAGS, SAFE, SONG, TIME
GLEE: CLUB, FALL, FULL, GLEE, GLUM, GOOD, GRIN, HOPE, JUMP, ROAR, SKIP, SOME
GLEN: ALAN, DALE, DELL, FORD, HILL, HOLT, HOME, JOHN, LOCH, MORE, SNOW, STAG, VALE
GLIB: GARB, GLUM
GLOW: BULB, BURN, DARK, FIRE, LAMP, NEON, ROOF, SLOW, SNOW, WARM, WIRE, WORM
GLUE: BIND, BLOB, CLUE, DRIP, GLUM, HOOF, JOIN, MEND, STEM, SUMS, TUBE, WELD
GLUM: BOOT, CHUM, DOUR, DUMB, FACE, GLEE, GLIB, GLUE, HANG, LOOK, MOAN, MOOD, SAID, SHOE
GNAT: BITE, BUZZ, DIRT, FLEA, FLEE, FROG, GNAW, ITCH, KNEE, TICK, WASP
GNAW: BITE, GASH, GNAT
GOAL: BALL, CLUE, DRAW, FOAL, GAME, GAOL, GOAL, GULL, IDOL, JAIL, KICK, LEES, NETS, POST, SAVE, SHOT, SOLD, TEAM, WORK
GOAT: BALE, BELL, BOAT, BULL, CALF, DAFT, DEER, FLOG, FOOL, GAOL, HERD, HOAR, HORN, KIDS, LUST, MILK, SKIN, SURE
GODS: FATE, SAKE
GOER: DOER
GOES: AWAY, BACK, BIKE, DOES, DOWN, FAST, FITS, GONE, HERE, HOLE, HOME, MAIL, RAVE, RUNS, WELL, WENT, WITH
GOLD: BAGS, BANK, BARS, BOND, COIN, DUST, FIND, GOOD, GRAM, HAIR, IDOL, INCA, JUNE, KEYS, LACY, LEAD, LEAF, LINK, LOOT, MINE, ONYX, PANS, PURE, RICH, RING, RUSH, SPUN, STUD, TOLD
GOLF: BALL, CLUB, FORE, FOUR, GAME, GULF, HOLE, LINK, PLAY, POSH, SAND, TEAM, TEAS
GONE: AFAR, AWAY, BEEN, CAME, COME, DARN, DAYS, DEAD, DIED, DONE, EASY, EVER, EXIT, FOOL, GOES, GONE, GONG, HERE, HOME, JUST, LEFT, LOSE, LOST, NONE, OVER, PAST, SALE, SANK, SEEN, SEND, SENT, SOLD, THEN, TOMB, TONG, USED, WENT, WEST, WIND, WITH
GONG: AWAY, BALL, BAND, BANG, BELL, BONG, DING, DONG, DOWN, GONE, GONG, HALL, HAND, HOME, KING, RANK, RING, SONG, TONG, WONG
GOOD: ABLE, BEER, BEST, BODY, BURP, CAME, CHAP, CHEF, CURE, DAMN, DARN, DEAD, DEAL, DEED, DIED, DIET, DOER, DOES, EASY, EGGS, EVEN, EVIL, FAIR, FEED, FEEL, FELT, FILM, FINE, FOOD, FORM, FOUL, FREE, GAVE, GIRL, GLEE, GOLD, HARM, HERO, HERS, HOLY, HOPS, IDEA, IDLE, JAZZ, JUST, KIDS, KIND, LAZY, LOAN, LUCK, MADE, MAKE, MARK, MEAL, MILK, MOOD, MOST, MUCK, MYTH, NEWS, NICE, OBEY, PLAY, POET, PROW, PURE, RAPE, RARE, REAL, RIPE, SAVE, SEXY, SHOT, SONG, SOON, SOUP, SUCH, TIME, TRUE, VERY, WELL, WINK, WISE
GOON: COON, RANG, SKIT
GORE: BULL, GUTS, LIAR, LION, LOOK, MUSH, TEAR, TORE
GOSH: BOOT, BUSH, DARN, FACE, GOSH, HECK, HELP, MINI, OUCH, PEST, PHEW, POSH, SNOB, WELL, WHAT
GOWN: CAPE, COAT, HALL, HOOD, LONG, MINI, ROBE, SARI, SILK, TIES, TOWN, WIRE
GRAB: COWS, CRAB, GARB, GRIP, HAND, HARD, HOLD, JUDO, MORE, PULL, PUSH, RAID, RASP, RUDE, SCOT, SELF, TAKE, TOOK
GRAM: GOLD, KILO, MASS, MONO, UNIT
GRAY: BLUE, CHAP, COLD, DARK, DRAB, DULL, EYES, FRED, GREY, HAIR, HEAD, KING, MARE, PINK, STAY
GREW: DEAD, FAST, FLEW, GROW, LIFE, ROSE, SLEW, STOP, TALL, TREE
GREY: AGED, BILE, BLUE, BRUM, CAPE, CLAY, DIKE, DOVE, DRAB, DULL, EARL, GRAY, GRIM, HAIR, HATS, HEAD, HERD, IRON, MARE, MICE, MIST, MOLE, MOTH, PAST, PINK, POOR, PREY, RAIN, ROAD, SCUM, SHIP, SNAP, STEP, SUIT, VOID, WALL, WARS
GRID: BIAS, MESH
GRIM: DANK, DARE, DARK, DULL, FACE, FEAR, GREY, GRIN, GUTS, HARD, MEAN, OGRE, POOR, SHAW, SOUR, TALE, TASK, TOWN, WISE, WOLF
GRIN: BEAM, BEAR, CHIN, EARS, FACE, GLEE, GRIM, LEAR, LEER, LIPS, LOVE, PINK, SIGH, SMUG, WINK
GRIP: FAST, FEAR, FEEL, FIRM, FIST, FORM, GRAB, HAIR, HAND, HARD, HELD, HOLD, IRON, LOSE, PAIN, PAWS, ROAD, SEND, SODA, SOLE, TAKE, VICE
GRIT: DIRT, LEES, SAND
GROW: BULB, CROP, FOOD, GREW, HAIR, IRIS, LIVE, MELT, PEAS, RAIN, RICH, ROOT, SEED, SIZE, SLOW, SOIL, STAY, TALL, TREE, WEED
GRUB: BAIT, FOOD, GIRL, MENU, MOTH, ROOT, SLUG, WORM
GULF: DEEP, GOLF, GULP, HOPE, PITY, SIDE, SUEZ, VOID, WIDE
GULL: BEAK, BIRD, BULL, BUOY, DOER, FISH, FOOL, GOAL, GUSH, HULL, SOAR, TING, WING
GULP: BEER, DOWN, FEAR, FOOD, GASP, GULF, HELP, OUCH, PINT, PULP, SICK, WIDE
GUMS: BOIL, BUMS, CHEW, CHUM, GUNS, LIPS, PINK, SUCK, WINE
GUNS: ARMS, ARMY, AWAY, BANG, DEAD, FIRE, GUMS, HUNT, KILL, NAVY, POPS, RAID, TANK, TOYS, WARS
GURU: EAST
GUSH: BLEW, GASP, GULL, SPEW
GUST: SIGH, SLUG
GUTS: ACHE, BURP, EGGS, FOOD, GORE, GRIM, MESS, SHOT, SKIN, SPEW
GWEN: AUNT, WONG
GYNT: PEER
HACK: BIKE, BRED, CHIP, CHOP, HECK, HEWN, HICK, HOCK, KICK, KNEE, LOUD, PONY, POOR, SHIN, SORE, SPIT, TACK, TREE, USED
HAEC: HICK
HAIL: BAWL, CALL, COLD, DAWN, FAIL, GALL, GANG, HAIL, HARD, HELL, KING, MARY, RAIN, SLOW, SNOW, THOU, WAIL, WELL, WIND
HAIR: ACNE, AIRY, APES, ARTS, AUNT, BALD, BAND, BOWS, BROW, BRUM, BUGS, BUNS, CLIP, COAT, COIF, COMB, COON, CROP, DANK, DECK, DOGS, DOLL, EARS, FACE, FAIR, FEND, FINE, FLAT, FUZZ, GIRL, GOLD, GRAY, GREY, GRIP, GROW, HARE, HATS, HEAD, LAIR, LICE, LIMP, LINE, LIPS, LOCK, LONG, LOSS, MALE, MANE, MARE, MOPS, NAPE, NEAT, OILY, PART, PLUG, POET, RAPE, ROLL, ROOT, SILK, SKIN, SOFA, SOFT, SONS, TAIL, TIDY, TRIM, VEST, WAVE, WAVY
HALE: BALE, SEMI
HALF: ALES, BACK, BAKE, CALF, DEAD, DEMI, FARE, FULL, HOUR, MILE, MOON, PART, PAST, PINT, SEMI, SOME, SPIN, TIME, WING, WITS
HALL: BALL, CLUB, DIGS, DOME, DOOR, ECHO, FAME, FEES, FILM, FORE, GONG, GOWN, HAVE, HIGH, HOME, KIRK, LAKE, LONG, MAIN, MARK, MEET, MESS, MOOT, PULL, ROOM, RULE, TOAD, TOMB, TOWN, VALE, VAST, WALL, YARD
HALT: LIMP, ROAD, SEMI, SIGN, SINE, STOP, TIDY, WAIT, WOOD
HAMS: AWAY, BEEF, BUTT, CURE, EGGS, FOOD, FOOL, LEAN, LEGS, MEAT, PIGS, PINK, PORK, YORK
HAND: AREA, ARMS, BAGS, BALL, BIRD, BODY, BONE, BURN, BUSH, CANE, CASH, CLIP, COOL, CUFF, DEAL, DECK, FARM, FATE, FEEL, FEET, FIRM, FIST, FIVE, FOOT, GASH, GIVE, GLAD, GONG, GRAB, GRIP, HELD, HIGH, HOLD, HOOK, HOUR, IRON, ITCH, JAMB, JIVE, LEER, LEFT, LEND, LIMB, LIMP, MADE, MAID, MAIN, MIKE, NAIL, NECK, PALM, PAWS, RASH, RING, ROPE, SOME, SORE, SPAN, SSSH, TOES, TOOL, WAND, WAVE, WAVY, WHIP, WIPE, YOUR
HANG: BACK, COAT, DEAD, DOLL, DOWN, DROP, GLUM, HEAD, HEAP, HECK, HIGH, HOOK, HUNG, JURY, KILL, LOOM, NECK, OVER, ROPE, THEM, WAIT, WONG
HANS: LOTS
HARD: BITE, BITS, BLEW, BLOW, BLUE, BOLD, BONE, BUMP, BUSY, COOL, COST, CYST, DEAD, DEAF, DEAL, DRUG, DUTY, EASE, EASY, EXAM, FAST, FIRM, FLOG, GRAB, GRIM, GRIP, HAIL, HART, HELD, IRON, JEEP, JUDO, KICK, KIND, KISS, LARD, LEAN, LINO, LOAF, LUCK, MONK, MUST, NAIL, NUTS, PANS, PANT, PITY, PRAY, PULL, PUSH, RAIN, RAKE, RANG, RASH, RASP, RATE, RIDE, ROCK, ROPE, SEAT, SNUB, SOFT, TASK, TEAK, TEST, TOIL, TOOL, URGE, VERY, WARE, WOOD, WORK
HARE: BALD, BASH, COAT, DOGS, DUCK, EARS, FAST, FISH, FOAL, FORM, HAIR, HART, LEGS, LONG, LOPE, SOUP, TRAP, WARE
HARM: CURE, DONE, EVIL, FARM, FEAR, FULL, GOOD, HATE, HEAL, HELP, HOPE, HURT, LESS, MAIM, NONE, PAIN, WARY
HART: DEAR, DEER, FART, HARD, HARE, HEAD, HIND, HOPE, HORN, HUNT, LAZY, LOVE, LUNG, MEAT, MIND, NAME, PANT, SONG, SOUL, TOIL, TONY, WINE
HASH: BASH, BEEF, CAKE, CHEF, DRUG, FOOD, GEAR, HEMP, IDEA, JUNK, MASH, MEAT, MESS, MUCK, NOSH, PIPE, RATS, RICE, SHIT, SLOW, STEW
HATE: BEAR, COLD, CORE, DATE, ENVY, EVIL, FATE, FEAR, FURY, GATE, GLAD, HARM, JACK, KILL, LATE, LEER, LIFE, LIKE, LOTH, LOVE, MATE, NAZI, PAIN, PETS, PITY, POPE, PUKE, RAGE, SATE, SNUB, SORE, TEAR, TRUE, VICE, WAIT, WARS, WHOM
HATS: BAND, BOWS, CAPS, ELMS, FELT, FETE, GENT, GREY, HAIR, HEAD, LIDS, MATS, NICE, PINS, SALE, SHOP, TOPS, WIGS
HAUL: BAWL, DRAG, SWAG
HAVE: BEEN, BOOK, BOTH, DONE, ENVY, GAIN, GAVE, GIVE, HALL, HELD, HOLD, KEEP, KEPT, LACK, LOVE, MUST, NEED, OURS, RIFE, THAN, TIME, TRIP, WANT, WISH
HAWK: BEAK, BIRD, DOVE, EYED, EYES, HUNT, KILL, KITE, LEAF, MOTH, PREY, PUKE, ROOK, SELL, SPIT, WING
HAWS: HIPS
HAZE: BLUE, COLD, DAZE, EYES, FRET, GAZE, HEAT, MAZE, MAZY, MIST, MOON, SMOG, THIS
HAZY: DAZE, MAZY
HEAD: ACHE, ACID, ARSE, BALD, BAND, BASH, BEAK, BEAN, BEER, BENT, BLOW, BODY, BONE, BOSS, BROW, BULL, BUMP, CAPE, CHAP, COIF, COIN, COLD, COMA, COSH, CRAG, CROP, CURE, DAFT, DEAN, DOME, EYES, FACE, FEET, FOOT, FORE, FROG, FULL, GRAY, GREY, HAIR, HANG, HART, HATS, HEEL, HOLE, HOOD, IDEA, KICK, KNEE, LION, LOAF, LONG, LUMP, MARE, MAST, MIND, MONK, NAIL, NAPE, NECK, OUCH, PAIN, PATE, PIER, POLL, REST, ROOF, SIZE, SORE, TAIL, TALE, TOES, TOOK, TWIT, WOOD
HEAL: BALM, CURE, DRUG, FEEL, FOOT, HARM, HEEL, HELP, HOOF, HURT, KILL, LUCK, MEAT, MEND, MIND, SALE, SAVE, SCAB, SHOE, SICK, SORE, SOUL, TEND
HEAP: BODY, COAL, DIRT, DUMP, DUNG, HANG, HIGH, JUNK, LOAD, LOTS, LUMP, MUCK, NEXT, PILE, SHIT, SOIL, TRUE, WOOD
HEAR: DEAF, EARS, ECHO, HEAR, HERE, LEAR, LOUD, NONE, THAT, THIS, TONE
HEAT: ARID, BEAT, BLOW, BODY, BOIL, BROW, BURN, COAL, COLD, DAZE, DOOR, DUST, FART, FETE, FIRE, FREE, FUEL, FUZZ, HAZE, JULY, JUNE, LEAN, LOGS, MELT, MOAN, NOON, OVEN, SEER, SORE, VEST, WARM, WAVE, WELD, WILT, WIRE
HECK: BECK, BLOW, DAMN, FLIP, GOSH, HACK, HANG, HECK, HELL, HELP, HICK, HOCK, JEER, LICK, LOST, NECK, PECK, RUSH, THAT, WHAT, YANK
HEED: LOCK
HEEL: BACK, BONE, CALF, FOOL, FOOT, HEAD, HEAL, HELL, HIGH, HOOF, JERK, KEEL, ROOT, SHOE, SLOB, SOCK, SOLE, TOES
HELD: ARMS, BACK, BOLD, DOWN, FIRM, GRIP, HAND, HARD, HAVE, HERE, HIGH, HOLD, KEPT, LIFT, LOSE, LOST, OPEN, OVER, TIED, WILL
HELL: BELL, BILL, BLOW, BURN, CELL, COLD, DAMN, DELL, DOLL, DOOM, DOWN, DRAG, EXAM, FATE, FEAR, FINE, FIRE, FUCK, HAIL, HECK, HEEL, HERE, HOLE, HOME, INTO, KIDS, LAND, OATH, OUCH, RAIN, RAPE, SINS, SUMS, TIRE, WARS, WIFE, YELL
HELP: ALLY, BEAM, BEER, CARE, CLUE, DENY, DRUG, EASE, FEND, FILM, FITS, GAVE, GOSH, GULP, HARM, HEAL, HECK, HICK, HOME, HURT, JUDO, KILL, KIND, LEND, LENT, LICE, LIFE, LIFT, LORD, LOSE, MAID, MATE, MOAN, NEED, OOPS, PRAY, PUSH, RAPE, SAKE, SAVE, SELF, TEND, THEN, TOOL, URGE, YELL
HEMP: DRUG, FLAX, HASH, HIGH, JUTE, MATS, ROPE, SACK, SEED, SUCK, WEED, WOOL
HENS: COOP, COUP, COWS, DUCK, EGGS, FARM, FEED, FENS, FOOD, GIRL, HUTS, LAID, PECK
HERB: MINT
HERD: BACK, COWS, GOAT, GREY, MASS
HERE: AWAY, BEEN, BORN, CALL, CAME, CAMP, CHEZ, COME, DART, ENDS, FIND, FREE, FROM, GOES, GONE, HEAR, HELD, HELL, JUST, KEPT, LAND, LIVE, LOOK, MADE, NEAR, NIGH, NONE, OVER, PARK, PAUL, SAFE, SENT, SHOP, SIGN, SMOG, STAY, WAIT, WERE, YOUR
HERO: ANTE, BOLD, BOND, BOOK, COWS, DEAD, DIED, FAKE, FAME, FOOL, GOOD, MYTH, PAYS
HERS: GIRL, GOOD, MINE, THIS
HEWN: HACK, ROCK
HIBS: GAOL
HICK: BURP, CUPS, DOCK, FOOL, HACK, HAEC, HECK, HELP, HOCK, JERK, RICK, TICK, TOWN, WOOD
HIDE: AWAY, BARK, BIRD, CAVE, CELL, FEAR, FIND, HUSH, LAIR, MASK, PARK, PREY, RIDE, SEEK, SHAM, SHOW, SKIN, TENT, WALL, WIDE
HIGH: BALL, BROW, COST, CRAG, DEEP, DIVE, DOME, DOOR, FIZZ, HALL, HAND, HANG, HEAP, HEEL, HELD, HEMP, HILL, JUMP, KICK, KITE, KNEE, LEAP, LOFT, LOOM, MAST, MOON, NIGH, NOON, NOTE, PEER, PILE, PLAY, RANK, RATE, RAVE, RENT, RIDE, ROAD, ROAR, ROOF, SEAS, SOAR, STEP, TALL, TEAS, TIDE, TONE, WALL, WEED, WIDE, WING
HIKE: BACK, BIKE, BOOT, DIKE, FEET, HILL, LIKE, MIKE, ROAD, TREK, WALK
HILL: AFAR, ANTS, APEX, BILL, BROW, BUDS, BUMP, CAMP, CAVE, COLE, CRAG, DALE, DELL, DOWN, DUNE, EDGE, FEAT, FILL, FILM, FOOL, GLEN, HIGH, HIKE, HOOK, HULL, LAKE, LANE, LOCH, LUMP, MILL, MIST, MOLE, OVER, PATH, PEAK, ROAD, ROCK, SAND, SCAR, SIDE, SLAY, SOME, STAB, TENT, TOPS, TORE, TREE, UPON, VALE, VIEW, WALK, WELL, WILL
HIND: DEER, FORE, HART, REAR
HINT: CLUE, TIPS
HIPS: BELT, BODY, BUST, GIRL, HAWS, HOPS, JIVE, LEGS, LIPS, MOVE, PIPS, ROSE, SEXY, SIZE, TIPS, WIDE
HIRE: BOAT, CAMP, CARS, FIRE, LOAN, RENT, RISK, SCAR, SELL, SOLD, SUIT, TAXI, TIRE, UPON, WIRE
HISS: FIRE, JOWL, KISS, LEAK, LIPS, MISS, PISS, PLOP, PUFF, PURR, RASP, SIGH, SPIT
HITS: SITS, TAPS, WITS
HIVE: BEES, HOVE, NEST, TREE
HOAR: BOAR, BULL, GOAT, MIST, ROAR, UGLY
HOAX: BOMB
HOBO: FREE
HOCK: HACK, HECK, HICK
HOGS: PIGS, WOGS
HOLD: BACK, BIND, COIL, CRAP, DROP, FAST, FEEL, FIND, FIRM, FLAY, FREE, GRAB, GRIP, HAND, HAVE, HELD, JUDO, KEEP, KEPT, LIFT, LINE, PICK, SHIP, TAKE, THEM, TOOK, TRAP, VICE, WAIT, WITH
HOLE: ANUS, ARCH, ARSE, BALL, BANG, BORE, BURN, CAVE, COLE, COVE, DARK, DARN, DEEP, DELL, DIGS, DIKE, DIVE, DOOR, DUMP, FALL, FULL, GASH, GOES, GOLF, HEAD, HELL, HOOP, HOPE, INTO, KEYS, LACE, LAIR, LEAK, LEAP, LEEK, LOOP, LOVE, MEND, MICE, MINT, MOLE, MOTH, NOOK, PAIL, PECK, PIPE, PITT, PLUG, POKE, POLO, PORT, ROAD, SEEP, SHIT, SHOE, SOCK, SPUD, TEAR, TOAD, TORN, VAST, WALL, WELL, WORM
HOLT: GLEN, JOLT
HOLY: BUSH, EVIL, GOOD, HOLY, HOPE, ISLE, LAND, MASS, MEEK, MONK, POPE, PURE, ROME, THAN, THOU, WRIT
HOME: AFAR, AWAY, BACK, BASE, BIKE, BORE, BREW, BRUM, CAME, CARE, CATS, CHEZ, COME, COSY, COWS, COZY, DEAF, DIGS, DIRT, DOOR, DRAG, FIRE, FLAT, FROM, GAME, GIFT, GLEN, GOES, GONE, GONG, HALL, HELL, HELP, INTO, JULY, KIDS, LAIR, LANE, LASS, LAST, LATE, LAWN, LEAK, LEFT, LIFE, LIMP, LIVE, LOFT, MADE, MAIL, MANE, MIST, MOOR, NEAR, NEST, OURS, PACK, PANG, PARK, PICK, REST, ROAM, ROOM, RULE, SAFE, SELF, SEND, SENT, SHED, SHIP, SPUN, STAY, TAKE, TAXI, TEAS, TIES, TIME, TOGA, TOOK, TOWN, TREK, TRIP, WARM, WENT, WHOM, WIFE
HONG: BONG, HONG, KING, KONG, PONG, WING, WONG
HONK: BELL, DUCK, HONK, HOOT, HORN, PEEP, PUKE, SICK, SPEW, TAXI, TONK, TOOT
HOOD: BEAR, CAPE, COAT, COWL, CROW, GOWN, HEAD, LENS, MONK, PRAM, RAIN, WINK
HOOF: CLAW, CLOP, DOWN, FEET, FOOD, FOOT, GLUE, HEAL, HEEL, HORN, IRON, SHOD, SHOE, SHOT, SKIN, TROT, WALK
HOOK: BAIT, BARB, BEAK, BOAT, CAST, CLIP, COAT, CURL, DOOR, FISH, HAND, HANG, HILL, JOHN, LINE, LOOP, MEAT, NAIL, NOOK, NOSE, REEL, WIRE
HOOP: BALL, BOWL, COIL, FAIR, GAME, GIRL, HOLE, HULA, IRON, LOOP, PLAY, RING, SKIP, SPIN, WIRE
HOOT: HONK, HORN, MOOT, TOOT
HOPE: CAPE, CARE, COVE, CURE, FATE, FEAR, FLAG, GLEE, GULF, HARM, HART, HOLE, HOLY, IDEA, JUST, KEEN, LAND, LESS, LEST, LIFE, LOPE, LOST, LOVE, LUCK, NONE, PASS, PITY, PLAN, PRAY, RISK, ROSE, SIZE, SOME, VAIN, VIEW, WANT, WISH
HOPS: BEAR, BEER, CORN, GAPS, GOOD, HIPS, JUMP, KENT, MALT, PICK, POPS, TOPS, WINE
HORN: BLEW, BLOW, BOSS, BULL, CAPE, DOSE, EWES, GOAT, HART, HONK, HOOF, HOOT, LOUD, NOTE, PIPE, POLL, PORK, POST, SHOE, SILO, SKIN, TAIL, TAXI, TOOT, TUBA, WIND
HOSE: BLEW, COSH, DOWN, FIRE, LEGS, PIPE, REEL, ROPE
HOST: ARMY, LORD, MASS, MINE, MIST, MOST, WINE
HOUR: DATE, HALF, HAND, LATE, LONG, MILE, PEAK, RUSH, SAND, TICK, TIME, WAIT, ZERO
HOVE: HIVE
HOWL: BABY, BARK, BAWL, FEAR, FELL, LOUD, MOAN, PINE, ROAR, WAIL, WOLF, YELL, YELP
HUFF: ALAN, BEAN, BLOW, CUFF, MOOD, PANT, PUFF, PUSH, SIGH, SNOB, SULK
HUGE: BEAR, BULK, CITY, HULK, SIZE, VAST
HUGH: FART
HULA: HOOP
HULK: HUGE
HULL: BULK, GULL, HILL, PROW, SHIP
HUME: FUME
HUMP: BUMP, LUMP
HUNG: HANG, RUNG
HUNT: ALES, BALL, BUNT, CLUE, CUNT, DEER, DOGS, FIND, FISH, GUNS, HART, HAWK, KILL, LOOK, LOSE, MEET, PANT, PREY, SEEK, STAG, TRAP
HURT: ACHE, BANG, BEAT, BELT, BITE, BOIL, BUMP, BUNT, BURN, CHIN, CLIP, COSH, CUTS, CYST, EARS, EYES, FALL, FEEL, FELL, FELT, FLOG, FULL, HARM, HEAL, HELP, JOLT, KICK, KILL, KNEE, LASH, LEAF, LIMP, MARK, MIND, MOAN, MOCK, MOTH, NAIL, OUCH, PAIN, PANE, PANG, PECK, PINS, PITY, ROAD, SCAR, SHIN, SHOT, SILL, SNUB, SOAR, SOFT, SORE, STAB, TRAP, WELL, WHIP
HUSH: BABY, BUSH, DAWN, HIDE, HUSH, MARY, MUSH, ROPE
HUTS: ARMY, CAMP, HENS, NUTS, PENS, REED, ROOF, SHED, SHUT, WOOD
HYDE: BORN, PARK
HYMN: AMEN, BOOK, DRAG, LORD, SING, SONG, TUNE
IAIN: JOHN
ICED: BUNS
ICLE: TEST
IDEA: CLUE, DAFT, FACT, GAME, GOOD, HASH, HEAD, HOPE, LONE, LOVE, MIND, NONE, PLAN, SHIT, WAVE, WHAT
IDLE: BONE, BUSY, CHAT, ERIC, FOOL, GOOD, JACK, KEEN, LAZY, LOAF, LOUT, MEAN, MEEK, PLAY, RACE, RASH, RICH, SELF, SLOW, TALK, THIN, WAIT, WORK
IDOL: BUSY, GIRL, GOAL, GOLD, IDOL, LAZY, LOST, RACE, RICH, STAR, TALL
ILLS: CARE, COLD, EVIL, FATE, LILY, MOAN, ODDS, PAIN, SICK, WEAK, WELL, WIFE, WOES
INCA: BLOC, BLUE, GOLD, LOST, PERU, POOP
INCH: CUBE, FOOT, FOUR, LOOP, MILE, MOVE, OVER, PARK, PART, ROCK, RULE, TAPE, WORM, YARD
INTO: CAME, DOOR, EXIT, FELL, FITS, FRAY, HELL, HOLE, HOME, JAIL, JUMP, LIFE, LOOK, MESS, MORE, ONTO, OVER, POUR, ROAM, ROOM, RUSH, SAIL, SEEP, TOWN, UNTO, UPON, WENT
IRIS: AUNT, BOAT, BULB, EYES, FLAG, GIRL, GROW, ISIS, LILY, NAME, SOFT, TREE
IRON: BARS, BASE, BENT, BREW, CAST, COAL, CORE, FIST, FLAT, FLUX, GATE, GREY, GRIP, HAND, HARD, HOOF, HOOP, LADY, LEAD, LOCK, LUNG, MASK, NAIL, NINE, RAGS, RAIL, RULE, RUST, SAND, SOUL, TONG, TRAP, WARE, WASH, WELD
ISIS: IRIS
ISLE: BUTE, DOGS, FAIR, HOLY, LAND, SKYE
ITCH: ANTS, BITE, BUGS, FLEA, FLEE, GAME, GNAT, HAND, LICE, MITE, OUCH, RASH, SKIN, SORE, SUIT
ITEM: NEWS, NEXT, WARE
IZZY: BONN, BUSY, GIRL, LOVE, OZZY, SPIN, WHAT
JACK: BALL, BEAN, BOOT, CARS, DASH, FILL, FLAG, FLAP, GILL, HATE, IDLE, JILL, JOHN, JUMP, NAME, PAIL, PALE, PLUG, TIRE, TYRE
JADE: ONYX
JAIL: BAIT, BARS, BIND, BIRD, CELL, FILE, FREE, GAOL, GOAL, INTO, JUNK, KEYS, LOCK, NICK, RAPE, WALL
JAKE: RAKE
JAMB: CAKE, CARS, DOOR, DRUM, HAND, LAMB, LIMB, OREE, OUCH, POST, SAIL, SOCK, TART
JANE: BILL, DEER, JOHN, LADY, MARY, ROSE, VAIN
JAPE: RAPE
JARS: LIDS
JAZZ: BAND, BEAT, CLUB, DRUM, FOLK, GOOD, JIVE, KICK, LOUD, MAZY, MESS, PAIN, PLAY, ROCK, SHOW, TRIO
JEAN: LEVI
JEEP: ARMY, CHAM, DUST, HARD, MOKE, PEEP, YANK
JEER: HECK, MOCK
JERK: BANG, BEND, COOL, DUCK, FAST, FISH, FOOL, HEEL, HICK, JOLT, JUMP, KNEE, LIMB, MOVE, NECK, OUCH, PAIN, POKE, PULL, PUSH, SNAP, TEAR, TWIT
JEST: BOAT, DARE, FOOL, JOKE, JUST, LEST, MOCK, PLAY, QUIP, SAID, TIME, TRUE
JEWS: ANTI, LEVI, OVEN, RAGS, RATS, SECT
JIBE: MOAN, MOCK
JILL: JACK, JOHN
JIVE: BAND, BEAT, DIVE, DRUM, FIVE, HAND, HIPS, JAZZ, JOKE, MOVE, RAVE, ROCK, ROLL
JOAN: AUNT, BIAS, JOHN
JOBS: SKIT
JOHN: BILL, BULL, DARN, DEAR, DIGS, DONE, GILL, GLEN, HOOK, IAIN, JACK, JANE, JILL, JOAN, JOHN, LEES, LONG, LOVE, MAIN, MANY, MARY, MATE, MIKE, NAME, NOON, PATE, PEEL, POPE, SAID, SHAW, SLOB, SNOW, WANE
JOIN: ALLY, ARMY, BIND, BONE, CLUB, COIN, DROP, GLUE, LINK, MATE, MEET, MESH, SAIL, TAKE, TEAM, WELD, WHAT
JOKE: ARMY, ARSE, BLEW, BOOK, BUNT, CORN, FLAT, JEST, JIVE, MOCK, POKE, PUKE, ROBE, SHIT, SICK, SKIT, SMUT, SOAP, WITS, WONG, YARN, YOLK
JOLT: BANG, BOLT, BUMP, HOLT, HURT, JERK, JUMP, MIND, PAIN, PONY, PUSH, STOP, THUD, TILT, VOLT, YANK
JOWL: HISS
JUDO: BANG, BELT, CHOP, FALL, FETE, GAME, GRAB, HARD, HELP, HOLD, KILL, LUDO, SICK, TOGA, WILT
JUDY: SPOT
JULY: GIRL, HEAT, HOME, JUNE, RAIN
JUMP: AREA, BANG, BEAM, BEAN, BUMP, DART, DEAD, DIVE, DOWN, FALL, FLEA, FLEE, FROG, GLEE, HIGH, HOPS, INTO, JACK, JERK, JOLT, LAKE, LAND, LEAP, LIMP, LONG, LOPE, MISS, MOVE, OVER, PECK, PROW, RIDE, ROPE, SHOW, SKIP, SKIT, TALL, UPON
JUNE: DATE, EXAM, GIRL, GOLD, HEAT, JULY, MOON, NICE, SAND, SWIM, TUNE, WARM, WOOL
JUNK: ACID, GARB, GEAR, HASH, HEAP, JAIL, LOOT, MUCK, PILE, WONG, YARD
JURY: DOCK, HANG, OATH
JUST: ABLE, FAIR, FINE, GONE, GOOD, HERE, HOPE, JEST, ONCE, ONLY, PUKE, SAME, TIME, TRUE, WHEN
JUTE: HEMP, LINO
KAHN: DELL
KALE: BEET, CROP
KANE: ABEL, ABLE, ADAM, BIRD, CANE, CORN, FILM, PAUL, RULE, SNOW, WHAT
KANT: CANT
KARL: MARX
KATE: KISS, KITE, MEET
KATY: TWIN
KEEL: HEEL
KEEN: ABLE, BOLD, CURT, DEAD, EDGE, FAST, HOPE, IDLE, MIKE, SEEN, SWOT, VERY, WIND, WORK
KEEP: AWAY, BACK, COOL, DOOR, DOWN, EARN, FEND, FIND, GIFT, GIVE, HAVE, HOLD, KEPT, LEFT, LEND, LOSE, LOST, MEAT, MINE, NEAR, PETS, SAFE, SAKE, SAVE, SELF, TIDY
KENT: DALE, DEAL, HOPS, LENT
KEPT: AWAY, BACK, BUSY, COOL, DATE, DOWN, HAVE, HELD, HERE, HOLD, KEEP, KEPT, LEFT, LONG, LOST, RIPE, SOLD, STAY, WELL, WEPT, WITH
KERB: CARD, CURB, EDGE, FOOT, ROAD, SIDE, STOP
KERR: ALAN
KEYS: DOOR, GOLD, HOLE, JAIL, LOCK, LOST, OPEN, RING, TOGS, TURN, WEST, YALE
KICK: BACK, BALL, BLOW, BOOT, FOOT, GAOL, GOAL, HACK, HARD, HEAD, HIGH, HURT, JAZZ, OBEY, OUCH, PAIN, PONY, PROD, PUSH, RAVE, SHIN, SHOE, SIDE, SORE
KIDS: BAWL, BOYS, DIRT, GANG, GOAT, GOOD, HELL, HOME, LIAR, NICE, PLAY, PRAM, QUIZ, THEM, TOYS, WANE
KILL: BANG, BOMB, BUMP, BURN, CURE, DARE, DEAD, FEED, FILL, FRAY, GUNS, HANG, HATE, HAWK, HEAL, HELP, HUNT, HURT, JUDO, KISS, LAMB, LIFE, LIVE, LOOT, MAIM, MANE, PAIN, PEST, PLOT, PREY, RAGE, RIFE, SAVE, SEEK, SILL, SITE, SLAY, STAB, THUG, WARS, WEED, WHAT
KILN: CLAY, LIME
KILO: GRAM
KILT: LEGS, SCOT, SOHO, SPUN, TILT
KIND: ALAN, CATS, EACH, GOOD, HARD, HELP, LADY, LIFE, LIKE, LOVE, MEAN, MIND, MOST, NESS, NICE, PAIR, SOFT, SORT, SOUL, TYPE, UGLY
KING: CARD, COLE, EARL, GIFT, GONG, GRAY, HAIL, HONG, KONG, LEAR, LEER, LION, PEER, POMP, ROAD, ROBE, RULE, SAGA, SAID, SEAL, SIZE, SNOW, TILE, TONG, WARD, WISE
KINK: BENT
KIRK: DALE, GATE, HALL, MOST, RUMP, TOWN
KISS: BIRD, BITE, BLOW, GIRL, HARD, HISS, KATE, KILL, LICK, LIFE, LIPS, LOVE, MISS, NAME, NECK, PASS, PECK, SEAL, SNOG, SNUG, SOFA, SUCK, WILL
KITE: BIRD, CROW, FLEW, FOOD, HAWK, HIGH, KATE, PREY, SITE, SOAR, WIND
KNEE: BEND, BONE, BULB, CALF, CYST, DEEP, FELL, FOOT, GASH, GNAT, HACK, HEAD, HIGH, HURT, JERK, KNEW, REST, SCAR, SHIN, YOUR
KNEW: CHAT, FACT, KNEE, KNOW, MINE, MUCH, ONCE, PAST, SAID, THEM, THEN, WELL, WHAT, WHEN
KNIT: DARN, FOOL, KNOT, MAKE, PURL, TING, WEAR, WITH, WOOL, YARN
KNOB: AXLE, BENT, COCK, DOOR, DOWN, DRAW, PISS, RAPE, SLOB, TURN
KNOT: BAND, FAST, FIST, FOUL, KNIT, LACE, LOOP, LOVE, REEF, ROPE, SHIP, SLIP, TIED, TIES, WANT, WOOD, WOOL
KNOW: DARK, FACT, KNEW, LIKE, LOVE, MIND, MUCH, SEEM, SILO, STOP, SURE, TELL, THAT, THEM, THIS, WHAT, WHEN
KONG: HONG, KING, KONG, TONG, WONG
LACE: BOOT, CORD, FINE, HOLE, KNOT, LACE, LACY, LINE, LOAD, NECK, NICE, RACE, SHOE, SILK, TIED, WING, WORK
LACK: BACK, BEAT, CARE, CASH, FILL, FOOD, FULL, HAVE, LAMB, LAND, LEND, LESS, LOSS, LOVE, MISS, NEED, NONE, PACE, POOR, SINE, SLOW, TIME, WANT
LACY: BILL, CREW, FINE, GOLD, LACE, LAZY, LUCY, NAME, NICE, PINK, RACY, ROSY, SEXY, SICK, SLIP, TRUE, VEIL
LADD: ALAN
LADS: LASS
LADY: AGED, AVON, BARN, BEAR, BIRD, CENT, CHAR, DAME, DEAR, DOCK, FAIR, GENT, GIRL, IRON, JANE, KIND, LAKE, LAND, LASS, LIKE, LORD, LOVE, LUCK, MALE, MARY, MISS, MUCK, NUDE, PEER, POSH, SATE, WIFE
LAID: BACK, DOWN, EGGS, HENS, LOVE, REST, SERF
LAIR: BEAR, CAVE, COAL, FOOL, HAIR, HIDE, HOLE, HOME, LIAR, LION, NEST, OGRE, ROOM, TALE, TRAP, TRUE, WOLF
LAKE: BLUE, BOAT, COOL, DEEP, EERY, ELMS, ERGO, FISH, FIVE, HALL, HILL, JUMP, LADY, LEAP, LIKE, LOCH, OARS, OVEN, POND, REED, SIDE, SWAN, SWIM, TREE, VIEW
LAMB: BEEF, CALF, CHOP, CLIP, EWES, FLAG, FOAL, FOOD, FOWL, JAMB, KILL, LACK, LEGS, LIKE, LIMB, LION, MARY, MEAT, MEEK, MEET, MINT, OVEN, SOUP, VEAL, WOLF, WOOL
LAME: DUCK, GAME, LIMP, POLO, POOR, SAME, TAME
LAMP: BIKE, BLOW, BLUE, BULB, CHOP, DARK, DESK, FLAG, GLOW, LAMP, LEAN, LIMP, LUMP, NEON, PLUG, POST, SNOG, WELD, WICK
LAND: ACES, AHOY, AREA, ARID, BOAT, DALE, DOCK, FARM, FLAT, FORE, GANG, HELL, HERE, HOLY, HOPE, ISLE, JUMP, LACK, LADY, LEVI, LORD, LOVE, MAIN, MARY, MINE, MOOR, OURS, PARK, PLOT, RENT, SEER, SITE, TILL, TUBA
LANE: ALLY, BUSH, DARK, DOWN, EDGE, ELMS, ENDS, GIRL, HILL, HOME, MOOR, PAIN, PARK, PATH, ROAD, ROSE, SKIT, TREE, WALK, WOOD
LANG: FLAP, TANG
LANK: ARMS, DANK, LIMP
LARD: BOIL, COOK, EGGS, HARD, LOST, MELT, MILK, PIGS, SICK, SKIN
LARK: NAVY, SING, SOAR, WOOD
LASH: BACK, BEAT, CANE, CASH, CORD, FLOG, FOAM, GASH, HURT, PAIN, WHIP, WINK
LASS: BIRD, DRIP, FARM, FINE, GIRL, HOME, LADS, LADY, MAID, MORE
LAST: ALAS, CRAP, DAYS, DONE, EVER, FIND, FIRS, FIST, HOME, LEAD, LIST, MILE, NEXT, PAGE, PAST, PORT, SEEN, SHOE, SOON, TIME, WORD, YEAR
LATE: ANUS, BACK, BOOK, CALL, DATE, FETE, HATE, HOME, HOUR, LOVE, MATE, MIND, MISS, OOPS, RAIL, SATE, SOON, TAXI, TILL, TIME, WAIT
LAUD: PRAY
LAVS: GENT
LAWN: HOME, LONE, MOLE, MOSS, SEED, TENT, TREE, YAWN
LAZE: LOPE
LAZY: ARTS, BUSY, CHAR, DAFT, DOER, DOZE, DOZY, DULL, EASY, FLEE, FOOL, GOOD, HART, IDLE, IDOL, LACY, LEAN, LIFE, LOAF, LOPE, MAZY, MICK, MILE, SELF, SLOB, SLOW, SOFT, WORK
LEAD: ARMY, BASE, CELL, CLUE, CORN, DOGS, DULL, GOLD, IRON, LAST, LUMP, PIPE, PLUG, PLUM, ROOF, SANK, SHOT, SKIP, TAPE, WALK, ZINC
LEAF: ADAM, BOOK, BUSH, DOCK, DUNG, FAGS, FIGS, FLAT, FOLD, GOLD, HAWK, HURT, LILY, LING, LOVE, PAGE, PALM, ROAD, ROOT, ROSE, SEED, SHED, SLOE, SLUG, STEM, TREE, TURN, TWIG
LEAK: BEAK, BOAT, DRIP, FLOW, FUEL, HISS, HOLE, HOME, LEEK, PAST, PIPE, PISS, PLUG, RAIN, SEEP, SINK, SLIP, STEW, TANK, TEAK
LEAN: BACK, BANK, BIAS, DESK, DOWN, FALL, HAMS, HARD, HEAT, LAMP, LAZY, LONE, MEAT, NEAT, OVER, POST, SLIM, SWAY, TALL, TEND, THIN, TILT, TIME, TRIM, VEAL, WIRY
LEAP: DARK, DOWN, DUNG, FALL, FROG, HIGH, HOLE, JUMP, LAKE, LOGS, LOOK, NUNS, WALL, YEAR
LEAR: GRIN, HEAR, KING, LEER, LIFE, LOOK, PORE
LECH: LOOK
LEEK: BOAT, BOIL, FOOD, HOLE, LEAK, PIPE, PISS, SEEP, SOUP, STEW
LEER: BEER, EVIL, EYES, FACE, GAZE, GRIN, HAND, HATE, KING, LEAR, LEER, LEWD, LOOK, LOOM, LUST, OGLE, PEER, ROLL, SNUB, UGLY, WEIR
LEES: BEER, BEES, DAYS, GOAL, GRIT, JOHN, LIES, MINE, NAME, STAN, WHAT, WIND, WINE, WIRE, WOOD
LEFT: BANK, BIAS, EXIT, FORK, GONE, HAND, HOME, KEEP, KEPT, LIES, LOBE, LOOK, OVER, PORT, SENT, SIDE, TOOK, TURN, WENT, WING
LEGS: ACHE, ARMS, BARE, BODY, BOWS, CALF, FEET, FOAL, FOUR, FROG, GIRL, HAMS, HARE, HIPS, HOSE, KILT, LAMB, LIMB, LOGS, LONG, LOVE, NICE, OPEN, PAIR, PEGS, SCAR, SEXY, SHIN, SOFT, TART, THIN, TOES, WALK, WEAK, WEAR
LEND: BOAT, BOOK, GIVE, HAND, HELP, KEEP, LACK, LOAN, LONE, LOSE, MEND, TAKE, TEND
LENS: CASE, EYES, HOOD, LOOK, ZOOM
LENT: BENT, FARE, FAST, GAVE, HELP, KENT, LOAN, OVER, OWED, TERM, XMAS
LESS: CARE, EVEN, FACE, FACT, HARM, HOPE, LACK, LIST, LUCK, MANY, MIND, MOOR, MORE, MOST, MOVE, MUCH, NESS, NONE, PLUS, ROOM, STAR, THAN, THAW, TIME, WIRE
LEST: BEST, CASE, EASE, EVEN, FEAR, FOOD, HOPE, JEST, LEST, LOSE, LOVE, LUST, MORE, MOST, NEST, PEST, THAT, TILL, WHAT, WHOM, ZEST
LETS: LIDS
LEUM: LINO
LEVI: CLUE, JEAN, JEWS, LAND, TELL, TOLL
LEWD: LEER
LIAR: BASE, BORN, DENY, FOOL, GORE, KIDS, LAIR, LIES, PEST, SAID, SEER, TRUE, UGLY
LICE: BODY, BUGS, CRAB, DICE, DIRT, FLEA, HAIR, HELP, ITCH, MICE, NICE, NITS, RATS, RICE, TICK, VICE, WIGS, WOOD
LICK: BEAT, CHEW, HECK, KISS, LIKE, LIPS, LOPE, LOVE, MILK, PICK, SEAL, SPIT, SUCK, TANG, TICK
LIDO: GALA
LIDS: BINS, CANS, DUST, EYES, HATS, JARS, LETS, LINO, PANS, POTS, SKID, TINS, TOPS
LIED: SITS
LIER: TRUE
LIES: DEAD, DIES, DOWN, FAKE, FIBS, FLAT, FOOL, FUZZ, LEES, LEFT, LIAR, LIES, NONE, PACK, SITS, SUCH, TALE, TELL
LIFE: ANEW, ANUS, ARMY, BABY, BODY, BRED, BUSY, COAL, DAYS, DEAD, DOGS, DRAG, EASE, EASY, EGGS, EVIL, FACT, FATE, FIND, FREE, GIVE, GREW, HATE, HELP, HOME, HOPE, INTO, KILL, KIND, KISS, LAZY, LEAR, LIMB, LIVE, LONG, LOOK, LOSE, LOVE, MARS, MATE, MESS, MINE, MODE, MOST, MOVE, NEXT, OWED, PART, PAST, PEER, POND, REAL, RIFE, RISK, SAKE, SAVE, SEED, SEEK, SINS, SIZE, SOLE, SOUL, SPAN, SUCH, THAT, THIS, TIME, TIRE, TOOK, TOWN, TREE, TRUE, WEEK, WHAT, WILD, WITS, WOMB, WORK, YOUR
LIFT: BANK, CAGE, DOOR, DOWN, DRAG, DROP, FACE, FORK, HELD, HELP, HOLD, LOAD, LOFT, OTIS, PICK, PULL, PUSH, RISE, SHOP, STOP, TAKE, TILT, WELL
LIKE: CORD, DRAW, ENVY, FEEL, FELT, FOND, GAME, HATE, HIKE, KIND, KNOW, LADY, LAKE, LAMB, LICK, LONE, LOTH, LOVE, MOST, NEAR, NICE, SAME, SEEM, SUCH, THEM, THIS, THUS, VICE, WANT, WHAT, WHEN, WISE, WISH, WORM
LILO: SILO
LILT: SWAY, WILT
LILY: ANON, FROG, GILD, ILLS, IRIS, LEAF, PINK, POND, POOL, ROSE
LIMB: ARMS, BODY, BONE, FOOT, HAND, JAMB, JERK, LAMB, LEGS, LIFE, MIND, TREE
LIME: DROP, KILN, LIMY, MIME, SAND, SODA, SOUR, TREE
LIMP: BUMP, DEAD, DRAG, FEET, FOOT, HAIR, HALT, HAND, HOME, HURT, JUMP, LAME, LAMP, LANK, LOPE, PAIN, PIMP, SICK, SLIM, SORE, WEAK
LIMY: ARMY, CLAY, FISH, LIME, PLUM, SOIL, WORD, YANK
LINE: AXIS, BASE, BEND, BODY, BROW, CAST, DART, DASH, DATE, DEAD, DOTS, DRAW, FILE, FISH, FOLD, FOUL, HAIR, HOLD, HOOK, LACE, LIST, LONG, LOOP, MAIN, MANE, MARK, MINE, NECK, PEGS, PIPE, POLE, RAIL, REEL, RULE, SHIP, SHOT, SIDE, SKIP, SLIM, SOFT, THIN, TIDE, TREE, TWIN, WAVY, WIRE, WORD
LING: CUFF, DING, DUCK, FISH, FOOT, FUNG, LEAF, LONG, MASS, MINE, MING, PING, RING, SING, TILE, TING, TONG, TUNE, WHAT, WORD
LINK: ARMS, BING, BOAT, BOND, CLUE, CUFF, GOLD, GOLF, JOIN, LINO, LIST, MINK, ROAD, TYPE, WORD, WORK
LINO: BLUE, COLD, DIRT, HARD, JUTE, LEUM, LIDS, LINK, PAIL, PLAY, SLIP, TILE, TYPE
LION: BEAR, CAGE, CUBS, EGGS, FEAR, GORE, HEAD, KING, LAIR, LAMB, MANE, PREY, RAGE, ROAR, SEAL, TAME, WILD
LIPS: CHAP, DUMB, FACE, GRIN, GUMS, HAIR, HIPS, HISS, KISS, LICK, LISP, LOVE, MIME, MISS, NICE, ORAL, PAUL, PINK, RASP, READ, SLOB, SNOG, SOFT, SPEW, TICK, TIPS, WARM, WINE
LISP: LIPS, SEEP
LIST: ARMY, BIAS, BOOK, CASE, CAST, EXAM, FAIL, FILE, FOOD, FORM, LAST, LESS, LINE, LINK, LONG, LOST, LUST, MEMO, NAME, PASS, REEL, ROTA, ROTE, SHIP, SHOP, SINK, THIS, TILE, TILT, WINE, WORD
LIVE: AREA, BAIT, BORN, COAL, COST, DEAD, DIGS, DOES, DULL, EASY, FEND, FREE, GIVE, GROW, HERE, HOME, KILL, LIFE, LONG, LOOK, LOVE, MOVE, RAIL, REAL, SHOW, STAY, WELL, WIRE
LIZA: DEAR
LOAD: BEAM, BEAR, BORE, BULK, CART, COAL, FLAT, HEAP, LACE, LIFT, LONG, LUCK, MIND, PACK, PILE, SACK, SAND, TRIP, WORK, YELL
LOAF: BAKE, BRAN, FOAL, HARD, HEAD, IDLE, LAZY, MALT, MEAT
LOAN: BANK, BOOK, DEBT, GIVE, GOOD, HIRE, LEND, LENT, MOAN, OWED, YARN
LOBE: EARS, FLAP, LEFT, PEAR
LOCH: BOAT, DEEP, GLEN, HILL, LAKE, NESS, OARS, TARN, TREE
LOCK: BOLT, CELL, COUP, DOOR, FORE, GATE, HAIR, HEED, IRON, JAIL, KEYS, NESS, PICK, RAPE, SAFE, SEAL, TONY, WAIT, YALE
LOFT: BARN, HIGH, HOME, LIFT, ROOF, TALL, TORY, WOOD
LOGS: AHOY, ARMS, BARK, BOIL, BOOK, BURN, COAL, CORN, FIRE, FOGS, HEAT, LEAP, LEGS, PILE, PINE, WOOD
LOIN: AFAR
LOLL: DOLL, LOPE
LONE: ARTS, BIRD, FEAR, IDEA, LAWN, LEAN, LEND, LIKE, ONLY, SELF, SOLE, SOME, STAR, WOLF
LONG: AGES, BACK, BEAK, BOAT, CANE, COMA, COOL, CORD, COZY, DAYS, FELT, GAZE, GOWN, HAIR, HALL, HARE, HEAD, HOUR, JOHN, JUMP, KEPT, LEGS, LIFE, LINE, LING, LIST, LIVE, LOAD, LOUD, MANE, MILE, NAME, NECK, ODDS, PAGE, PANG, PIER, PINE, PIPE, ROAD, ROBE, SARI, SHIP, SIGH, SONG, STAY, SUCH, TAIL, TALL, THIN, TIME, TOES, TREE, TREK, TRIP, TUBE, WAIT, WALK, WEAK, WIDE, WIRE, WISH, YARD, YEAR
LOOK: BABY, BACK, BELL, BOOK, CARE, DOWN, FACE, FAKE, FIND, GAZE, GLUM, GORE, HERE, HUNT, INTO, LEAP, LEAR, LECH, LEER, LEFT, LENS, LIFE, LIVE, LOST, NOOK, OVER, PEAR, PEER, PIER, PROW, READ, SEEK, SEEM, SEXY, SHOW, SILL, STOP, TEND, TOOK, VIEW, WINK
LOOM: BODY, BOOM, HANG, HIGH, LEER, MILL, OVER, SPIN, WEFT, WOMB, WOOL, ZOOM
LOON: DAFT
LOOP: BEND, CARD, COIL, FILM, GAME, HOLE, HOOK, HOOP, INCH, KNOT, LINE, NAVY, PILL, RING, ROPE, SPUN, WIRE, WOLF, WOOL
LOOT: ARMY, BAGS, BANK, BOOT, CASH, EARN, FIND, FOOD, FOOL, GAIN, GOLD, JUNK, KILL, MOOT, RAID, RAPE, SWAG, TOOT, TUNE
LOPE: ANTE, ANTI, DEER, DOPE, FOOL, HARE, HOPE, JUMP, LAZE, LAZY, LICK, LIMP, LOLL, LOUP, NOPE, POPE, ROPE, SOAP, WALK, WOLF
LORD: AMEN, AVON, DAME, EARL, HELP, HOST, HYMN, LADY, LAND, MUCK, NONE, OVER, PEER, PIER, RING, SEER, SERF, SUCH, TILE
LORE: FOLK
LOSE: CASH, COAT, DROP, FAIL, FIND, FRET, GAIN, GONE, GRIP, HELD, HELP, HUNT, KEEP, LEND, LEST, LIFE, LOSS, LOST, MIND, MISS, PASS, SACK, SAVE, TIES, TIME, WAGE
LOSS: DEAD, DEBT, EVEN, FATE, FIND, FINE, GAIN, HAIR, LACK, LOSE, LOST, RISK, YOUR
LOST: BOAT, CHEZ, CORD, DAZE, DOLL, FEAR, FIND, FREE, FUND, GAME, GONE, HECK, HELD, HOPE, IDOL, INCA, KEEP, KEPT, KEYS, LARD, LIST, LOOK, LOSE, LOSS, LUCK, MAZE, MAZY, MISS, PALE, RING, SEEK, SOLD, SOUL, SUIT, TREK
LOTH: FREE, HATE, LIKE, SLOW, SOME, UGLY, WANT, WHAT
LOTS: ABEL, BAGS, BETS, CAST, DRAW, GAIN, GAME, HANS, HEAP, MANY, MASS, MORE, MOST, MUCH, NONE, OWED, PILE, RIFE, SALT, SOME
LOUD: BANG, BAWL, BOLD, BOOM, CHAT, HACK, HEAR, HORN, HOWL, JAZZ, LONG, LOUT, MOAN, RANG, READ, ROAR, SAID, SASH, SING, SLAP, SOFT, TALK, TUBA, WEAK, YELL
LOUP: LOPE
LOUT: BRUM, IDLE, LOUD, SLOB, THUG
LOVE: ALAN, ARMS, BABE, BILL, BIRD, BITE, BOLD, BOND, CARE, COVE, COZY, DEAR, DEEP, DOVE, DRUG, ENVY, FEAR, FOLK, FREE, FRET, FUCK, GAVE, GIRL, GIVE, GRIN, HART, HATE, HAVE, HOLE, HOPE, IDEA, IZZY, JOHN, KIND, KISS, KNOT, KNOW, LACK, LADY, LAID, LAND, LATE, LEAF, LEGS, LEST, LICK, LIFE, LIKE, LIPS, LIVE, LUST, MAKE, MATE, MIST, NEED, NICE, NUDE, ORAL, OURS, PIER, PITY, PLAY, POEM, POET, PRAY, RAIN, RING, RISK, ROSE, SAFE, SAKE, SEXY, SOFT, TEND, THAN, TOOK, TRUE, URGE, VERB, WANT, WARM, WHOM, WIFE, WINK, WITH, WOMB
LUCK: ACES, DICE, DRAW, DUCK, FAIR, FATE, GOOD, HARD, HEAL, HOPE, LADY, LESS, LOAD, LOST, MINE, NONE, PASS, PAWS, SUCH, SUCK
LUCY: LACY
LUDO: DICE, JUDO
LUKE: COOL, MARK
LULU: BOOM
LUMP: BLOB, BOIL, BUMP, CLAY, CLOT, COAL, COSH, CYST, DUMP, FOOD, HEAD, HEAP, HILL, HUMP, LAMP, LEAD, MASS, PILE, RISE, ROAD, SHIT, SLAB, SOIL, SORE
LUNE: MOON, VALE
LUNG: FAGS, FISH, FROG, GILL, HART, IRON, SACK, TUBE, WORM
LUST: BODY, BUST, ENVY, FUCK, FULL, GOAT, LEER, LEST, LIST, LOVE, MUST, PAIN, PANG, RAPE, WANT
MACK: MICK
MADE: AWAY, BORN, CAKE, DOLL, DONE, EASY, FIRM, FROM, GOOD, HAND, HERE, HOME, MAID, MAKE, MILK, SANE, SELF, TEAS, TEST, WELL, WORK
MAGI: SEER
MAID: CHAR, COOK, COWS, DAME, ELSA, FAIR, FARE, GIRL, HAND, HELP, LASS, MADE, MARY, MAUD, MILK, RAID, RITA, TREE, WORK
MAIL: BOAT, COAT, DESK, FAIL, GATE, GOES, HOME, MALE, NAIL, NEWS, PALE, POST, SEND, SORT, TIME, VEST, WALK
MAIM: HARM, KILL
MAIN: BEAM, FUSE, HALL, HAND, JOHN, LAND, LINE, MAIN, MOST, PIPE, PLUG, REAR, ROAD, SAIL, STAY, VAIN
MAKE: BAKE, CAKE, DOES, EARN, FORM, GAIN, GIRL, GIVE, GOOD, KNIT, LOVE, MADE, MEND, PACE, PLAN, RAKE, TAKE, TIME, UNIT, URGE, WHAT
MALE: ALAN, CHAP, CLUB, DARK, EARL, EVEN, GENT, HAIR, LADY, MAIL, MARE, MATE, MISS, NAIL, PALE, SALE, SONS, SOUL, WOLF
MALT: BEAR, BEER, CORN, HOPS, LOAF, SACK, SALT, WALK
MANE: COAT, CORN, HAIR, HOME, KILL, LINE, LION, LONG, MARE, PONY, TAIL
MANY: AGES, DEAD, FISH, GAME, JOHN, LESS, LOTS, MASS, MICE, MORE, MOST, MUCH, NONE, RUSH, SINS, SOME, THEM
MARE: COLT, DEER, FOAL, GRAY, GREY, HAIR, HEAD, MALE, MANE, MARE, STUD
MARK: BLOT, BLUE, BOOK, COPY, DOWN, EDEN, EXAM, FOUR, GAME, GOOD, HALL, HURT, LINE, LUKE, NAME, PASS, POLO, SCAR, SEAL, SIGN, SITE, SLUR, SPOT, TAPE, TEST, TICK, TIDE, TIME, WIPE, WORK
MARS: BARS, DUST, LIFE, MOON, WARS
MARX: CARL, FOOL, KARL, RACE
MARY: ANNE, ANTE, AUNT, BILL, BLUE, CAPE, FACE, FEET, FLOE, GAVE, GIRL, HAIL, HUSH, JANE, JOHN, LADY, LAMB, LAND, MAID, MARY, MEND, MINE, NAME, NICE, ROSE, WARY, WOMB
MASH: BASH, BRAN, BREW, CASH, HASH, PULP, SPUD
MASK: BALL, BEER, COSH, FACE, FAKE, FURY, HIDE, IRON, PLAY, PLOT, RASP, SMOG, TAPE, TASK, VEIL, YORK
MASS: BATH, BLOB, BULK, COLE, DEAD, GRAM, HERD, HOLY, HOST, LING, LOTS, LUMP, MANY, MESS, PIER, PRAY, REST, RIOT, SWAG
MAST: AHOY, BOAT, CROW, FLAG, FORE, HEAD, HIGH, MOBY, POLE, SAIL, SHIP, TALL, WIRE, WOOD
MATE: BILL, BIRD, CELL, CHUM, DATA, FATE, FLAT, FOOL, GIRL, HATE, HELP, JOHN, JOIN, LATE, LIFE, LOVE, MALE, MEAT, NEST, NICK, PAIR, PATE, PLAY, RATE, ROOM, SATE, SHIP, SPUD, TEAM, WIFE, WORK
MATS: CATS, HATS, HEMP
MAUD: AUNT, MAID, MAZY
MAZE: CORN, DAZE, HAZE, LOST, MAZY, MESH, OATS, PARK, PATH, RATS, RICE, SEED, TRAP, WOOD
MAZY: CORN, GIRL, HAZE, HAZY, JAZZ, LAZY, LOST, MAUD, MAZE, MAZY, NAME, WHAT
MEAD: EDAM, FEED
MEAK: MILD, WEAK
MEAL: BEAN, BONE, BRAN, BURP, CAFE, CHEF, COOK, CORN, CURE, DIET, EATS, FISH, FOOD, FORK, GOOD, MEAT, MENU, OATS, PACK, REST, SATE, SOUP, TIME, WINE, WORM
MEAN: BASE, BEAN, CRIB, EASY, GRIM, IDLE, KIND, MODE, NICE, POOR, TEST, TIME, WAYS, WELL
MEAT: BAKE, BALL, BEEF, BITE, BODY, BONE, CANS, CHEW, CHOP, COOK, CRAB, CUTS, DEER, DIET, DISH, EATS, FEED, FISH, FOOD, HAMS, HART, HASH, HEAL, HOOK, KEEP, LAMB, LEAN, LOAF, MATE, MEAL, MEET, MILK, NICE, PATE, PIES, PORK, RARE, RIBS, SEAL, SHOP, STEW, SUCK, TIME, VALE, VEAL, WAVE
MEEK: HOLY, IDLE, LAMB, MILD, MILK, POOR, SOFT, WEAK, WILL
MEET: BROW, BUMP, DISH, DOOM, ENDS, FOOD, GIRL, HALL, HUNT, JOIN, KATE, LAMB, MEAT, MIRE, MOOT, NEAT, NEED, PARK, PART, PLAN, RACE, SOON, THEM, TIME
MELT: BELT, BURN, CAST, FLOW, GROW, HEAT, LARD, OOZE, POUR, SALT, SLOP, SNOW, SOFT, THAW, WELD, WILT
MEMO: LIST
MEND: BEND, BIND, CURE, DARN, FEND, FOLD, GLUE, HEAL, HOLE, LEND, MAKE, MARY, RUIN, SEND, SHOW, SOCK, SORT, TEAR, TEND, TIME, TORN, WAYS, WELD
MENT: BASE, MOVE
MENU: FOOD, GRUB, MEAL
MESH: FINE, FOIL, GEAR, GRID, JOIN, MAZE, MESS, TORN, WIRE, WORK
MESS: ARMY, ARSE, DESK, DIRT, DOGS, DUMP, DUNG, FOOD, FOUL, GUTS, HALL, HASH, INTO, JAZZ, LIFE, MASS, MESH, MESS, MUCK, NESS, OILY, PUKE, PULP, RASH, ROOM, RUIN, SCAR, SHIT, SICK, SLOB, SUCH, TIDY, TINS
MICE: BAIT, BRED, CATS, DAWN, DIRT, FLEE, GREY, HOLE, LICE, MANY, MOLE, NICE, NONE, PEST, PETS, RATS, TRAP, VICE
MICK: BOSS, DICK, FINN, FOOD, LAZY, MACK, MIKE, MOKE, NICK, PEEK, PISS, TAIL, TAKE
MIKE: BIKE, CHAP, COWL, DIKE, HAND, HIKE, JOHN, KEEN, MICK, MOST, NAME, OWEN, PETE, SHAW, SING, SONG, TOWN, WIRE
MILD: BEER, CALM, COLD, DAMN, MEAK, MEEK, MILD, NICE, PAIN, SOFT, TAME, WARM, WIND
MILE: FOOT, FOUR, FROM, HALF, HOUR, INCH, LAST, LAZY, LONG, MISS, POST, RACE, RAIN, ROAD, STOP, WALK, YARD
MILK: BABE, BABY, BOIL, BOWL, CALF, COLD, CONE, COOL, COWS, DIET, DISH, EGGS, GALA, GILL, GOAT, GOOD, LARD, LICK, MADE, MAID, MEAT, MEEK, OVEN, PAIL, PINT, POUR, PURE, SICK, SILK, SOUP, SOUR, SUCK, TEAK, TRAY, WARM, YOLK
MILL: CORN, FLOW, GIRL, HILL, LOOM, MULL, POND, PULP, RACE, WEED, WILL, WIND, WOOL
MIME: ACTS, COPY, DUMB, LIME, LIPS, PLAY, SING
MIND: ACID, ARID, BEND, BENT, BIND, BLOW, BODY, CARE, DIRT, EVIL, FEED, FIRM, FULL, HART, HEAD, HEAL, HURT, IDEA, JOLT, KIND, KNOW, LATE, LESS, LIMB, LOAD, LOSE, PAIN, REST, SANE, SENT, STEP, TIDY, UPON, WEAK, WILL, WIND, WITS
MINE: ALSO, BANG, BOMB, COAL, COLE, DOWN, FAME, FEET, FLAG, FLAT, GOLD, HERS, HOST, KEEP, KNEW, LAND, LEES, LIFE, LINE, LING, LUCK, MARY, NAME, ONES, ONLY, OURS, OWED, PITT, ROBE, SAKE, SALT, SINE, TAKE, TAPS, THAN, YOUR
MING: LING, TONG, VASE
MINI: AMOK, GOSH, GOWN
MINK: COAL, COAT, FARM, FIRS, LINK, RICH, SOFT, WRAP
MINT: CHEW, COIN, HERB, HOLE, LAMB, OPAL, PEAS, POLO, SODA, SUCK
MIRE: BARN, COIN, DIRT, DUNG, MEET, MUCK, POND, QUAG, SHIT, SINK
MISS: DUCK, FAIL, FLIP, GIRL, HISS, JUMP, KISS, LACK, LADY, LATE, LIPS, LOSE, LOST, MALE, MILE, NEAR, OMIT, PAST, PINE, POOR, SKIP, SNUB, SPIT, TAKE, TRIM, TUBE, WARD
MIST: AHOY, AIRY, BODY, DAMP, FILM, FLIT, GREY, HAZE, HILL, HOAR, HOME, HOST, LOVE, PIST, RAIN, SMOG, TANG
MITE: BRAT, FLEA, ITCH
MOAN: BOWL, GLUM, HEAT, HELP, HOWL, HURT, ILLS, JIBE, LOAN, LOUD, PAIN, PANT, ROAR, SIGH, WAIL, WEEP, WHAT
MOAT: MOOT
MOBY: MAST
MOCK: AMOK, BIRD, CHOP, EXAM, FAKE, HURT, JEER, JEST, JIBE, JOKE, MOCK, PITY, SHAM, SKIT, SOCK, TONY
MODE: LIFE, MEAN, MOOD, NODE, ROAD, TAPE, TYPE
MODS: GEAR
MOKE: JEEP, MICK
MOLD: CLAY
MOLE: ANUS, DARK, DIKE, FACE, FEET, GREY, HILL, HOLE, LAWN, MICE, MOVE, PLUG, SKIN, SPOT, TOAD, WELL, WORM
MOLL: POLL
MONK: BALD, CELL, CHIP, DALE, HARD, HEAD, HOLY, HOOD, PAUL, POPE, PRAY, ROBE, TAME, TREE, VEIL
MONO: GRAM
MOOD: BLUE, BOOM, GIRL, GLUM, GOOD, HUFF, MODE, SOUR, TEAR, TONE
MOON: BLUE, COON, DUST, FULL, GIRL, HALF, HAZE, HIGH, JUNE, LUNE, MARS, NOON, OVER, PAIL, POLO, ROOM, SHIP, SHOT, STAR, TIDE, WANE
MOOR: BOGS, BOYS, CRAG, DALE, DART, DOOR, FELL, HOME, LAND, LANE, LESS, MORE, OPEN, PEAT, RAIN, ROOM, TOWN, TURK, WILD, WOOD
MOOT: BIRD, BOOT, COOT, DEAD, DUMB, FINE, FOOD, FOOT, HALL, HOOT, LOOT, MEET, MOAT, ROOT, SOOT, STAG, SWAN, TARN, TOOT, WHAT, WORD
MOPS: CHAR, COPS, DISH, HAIR, PAIL, WALL
MORE: BORE, BULK, CASH, EVER, FOOD, FOUR, GLEN, GRAB, INTO, LASS, LESS, LEST, LOTS, MANY, MOOR, MORE, MOST, MUCH, NEED, NEXT, NONE, ONCE, OVER, PASS, QUID, RACE, ROPE, SAGA, SELL, SINE, SOME, SORE, THAN, TIME, TORE, TURN, WAGE, WANT, WHAT
MORN: DAWN
MOSS: BARK, DAMP, DANK, FERN, LAWN, MOSS, PAGE, PEAT, ROCK, ROOF, SIDE, SOFT, TREE, TURF
MOST: BEER, BEST, BOTH, BULK, COST, EVEN, FLOG, FOLK, FORE, FULL, GOOD, HOST, KIND, KIRK, LESS, LEST, LIFE, LIKE, LOTS, MAIN, MANY, MIKE, MORE, MUCH, MUST, NONE, POST, SELL, SOME, VERY, WHAT
MOTH: BALL, BIRD, CURL, DARK, DUST, GREY, GRUB, HAWK, HOLE, HURT, MYTH, PEST, SILK, SOFT, TRAP, WING, WOOL
MOVE: AWAY, BACK, EVER, FAST, GIRL, HIPS, INCH, JERK, JIVE, JUMP, LESS, LIFE, LIVE, MENT, MOLE, NOSE, OVER, PUSH, ROOM, STAY, STOP, SWAY, TILT, TURN, WALK, WORM
MUCH: BULK, EATS, FOOD, FULL, GAIN, KNEW, KNOW, LESS, LOTS, MANY, MORE, MOST, NESS, READ, SCUM, SHOW, SUCH, TALK, TIME, VERY, WORK
MUCK: AMOK, CART, DIRT, DUCK, DUMP, DUNG, FARM, GOOD, HASH, HEAP, JUNK, LADY, LORD, MESS, MIRE, PIGS, PILE, PUSS, RAKE, SCUM, SHIT, SMUT, SOIL
MUFF: SUDS
MUGS: CLAY
MULE: PACK
MULL: MILL
MURK: SEER
MUSE: FURY
MUSH: GORE, HUSH
MUST: BEER, BIRD, DAMP, DUTY, HARD, HAVE, LUST, MOST, NEED, NOTE, OBEY, TAKE, URGE, WILL, WINE, WONT
MUTE: DEAF, DUMB
MYTH: ECHO, GOOD, HERO, MOTH, TALE, TRUE
NACK: NICK
NAIL: BENT, BITE, COIN, CRAB, DEAD, DOOR, DOWN, EDGE, FILE, HAND, HARD, HEAD, HOOK, HURT, IRON, MAIL, MALE, ONYX, RUST, SKIN, STUB, TACK, THIN, WALL, WASH, WOOD
NAME: BLOB, BOND, CALL, CHEZ, DAME, EDAM, FAME, FLOE, FORM, GIRL, HART, IRIS, JACK, JOHN, KISS, LACY, LEES, LIST, LONG, MARK, MARY, MAZY, MIKE, MINE, NICK, NOUN, PAUL, POSH, RANK, SAKE, SAME, SELF, SHAW, SIGN, SOFA, THEM, THIS, TOOK, WANE, WOOD, WORD, YOUR
NAPE: HAIR, HEAD, NECK, OPEN, RAPE
NAVY: ALLY, ARMY, BLUE, BOAT, CAMP, GUNS, LARK, LOOP, NONE, RANK, SHIP, WAVY, WREN
NAZI: ARMY, EVIL, FLAG, HATE, OVER, PAIN, THUG
NEAR: AFAR, ALSO, AWAY, CAME, CITY, COME, DEAR, EAST, FAIR, HERE, HOME, KEEP, LIKE, MISS, NEXT, NIGH, SEEM, SOFA, SOON, WEAR
NEAT: CANS, COLD, FEAT, HAIR, LEAN, MEET, NICE, PRIM, SLIM, SURE, TIDY, TRIM, UGLY
NECK: BAND, BITE, BODY, BOIL, CHIN, CROP, EYES, FACE, HAND, HANG, HEAD, HECK, JERK, KISS, LACE, LINE, LONG, NAPE, PAIN, PECK, PINS, POLL, POLO, ROPE, RUNG, SKIN, SNOB, SNOG, SOFA, SORE, SWAN, THIN, TIES, WASH
NEED: CARE, DUTY, FELT, FILL, FOOD, GIVE, HAVE, HELP, LACK, LOVE, MEET, MORE, MUST, POOR, REED, URGE, WANT, WHAT
NEIL: ALAN
NEON: BULB, CITY, GLOW, LAMP, SIGN
NERO: ROME
NESS: BOMB, CAPE, COLD, FOUL, KIND, LESS, LOCH, LOCK, MESS, MUCH, SICK, WEST
NEST: ANTS, BABE, BEES, BEST, BIRD, COME, COZY, CROW, EAST, EGGS, GAME, GIRL, HIVE, HOME, LAIR, LEST, MATE, REST, TREE, TRIM, TWIG, WARM, WASP, WILL
NETS: GOAL
NEWS: CAST, FACT, GLAD, GOOD, ITEM, MAIL, PIPS, RAPE, REEL, RIOT, ROOM, THEM, TIME, WEEK
NEWT: FISH, FROG, POND, POOL, SWIM, TANK, TOAD, WEED
NEXT: DOOR, HEAP, ITEM, LAST, LIFE, MORE, NEAR, NEXT, SKIN, SOON, TEXT, THEN, THIS, TILL, TIME, TURN, WEEK, WORD, YEAR
NICE: ACID, ANTS, BACH, BARE, BODY, CAKE, CHAP, COIF, COVE, COZY, CUTE, DICE, EASE, EASY, EATS, EVER, FELT, FINE, FOOD, GARB, GIFT, GIRL, GLAD, GOOD, HATS, JUNE, KIDS, KIND, LACE, LACY, LEGS, LICE, LIKE, LIPS, LOVE, MARY, MEAN, MEAT, MICE, MILD, NEAT, NINE, PATE, PETS, RICE, SAFE, SELF, SNOG, SOFT, SOUR, TART, THUG, TORY, TUNE, UGLY, VERY, VICE, VIEW, WARM, WISH, WOGS, WORK
NICK: BARS, BEAT, FLOG, GAOL, JAIL, MATE, MICK, NACK, NAME, NOOK, NUDE, TAKE, THIS, TIME
NIGH: DARK, HERE, HIGH, NEAR, NOON, REIN, SIGH, SOON, TIME, UPON, WELL
NILL: ZERO
NINE: CATS, ELMS, EVEN, FEET, FIRS, FIVE, IRON, NICE, PAST, PINS, PLAY, SIZE, TEEN, TIME, ZERO
NITS: LICE, WITS
NOAH: BIRD, BOAT, DOVE, FOOD, SARK
NODE: ANTE, MODE
NOEL: FUEL
NOGS: EGGS, WOGS
NOIR: CAFE
NONE: BOTH, CARS, CENT, CYST, DAMN, DUTY, ELSE, ENVY, FILE, FOOD, GONE, HARM, HEAR, HERE, HOPE, IDEA, LACK, LESS, LIES, LORD, LOTS, LUCK, MANY, MICE, MORE, MOST, NAVY, OMIT, ONLY, PITY, POET, RISK, RULE, SOME, SOUL, SUCH, WILL, WITS, WOOL, ZERO
NOOK: COSY, COZY, CRAG, DELL, FOOL, HOLE, HOOK, LOOK, NICK, TOOK, WOOD
NOON: HEAT, HIGH, JOHN, MOON, NIGH, SOON, TIDE, TIME
NOPE: BORE, LOPE
NOSE: BEAK, BEES, BLEW, BLOW, CHIN, COLD, CONE, CORE, CUFF, DOSE, DRIP, DROP, EARS, EYES, FACE, HOOK, MOVE, NOSY, PEAK, PICK, POKE, POSE, PROW, PULL, ROOT, SMUT, SNOB, SNUB, SPOT, STUB, TAIL, TILT, UGLY, WIPE, YEAR
NOSH: FEED, HASH
NOSY: EARS, FACE, FOOD, FOUR, NOSE, PEAK, POSY, RUDE
NOTE: BACH, BANK, BILL, BLEW, BOOK, CASE, DOWN, FLAT, FORM, HIGH, HORN, MUST, PAGE, QUID, RASP, READ, ROTE, SING, SONG, SUNG, TONE, TUNE, WAIT, WELL
NOUN: CASE, FRED, GIRL, NAME, TIRE, VERB, WORD
NOUS: CHEZ
NOVA: BOOK, STAR
NUDE: BARE, BATH, BEAR, BODY, CAMP, COLD, DRAW, FILM, GIRL, LADY, LOVE, NICK, POSE, PURE, RUDE, SEMI, SHOW, SKIN, TITS
NUFF: COIF
NULL: FULL, VOID
NUNS: LEAP
NUTS: BAGS, BATS, BOLT, CHEW, COON, DIET, EGGS, FATE, FITS, HARD, HUTS, PATE, PEAS, POPE, SALT, SATE, SECT, TREE, WITS
OAKS: ELMS
OARS: BEAT, BOAT, LAKE, LOCH, PARK
OATH: BOND, BOOK, BOTH, CORE, CUSS, DAMN, HELL, JURY, TAKE, VINE, WORD
OATS: BRAN, CORN, CROP, EATS, FEED, FOOD, MAZE, MEAL, PONY, REAP, RICE, SACK, SCOT, WILD
OBEY: DRAG, DUTY, FAST, GOOD, KICK, MUST, RULE, WIFE, WILL
OBOE: REED, TUBA
ODDS: DICE, ENDS, EVEN, ILLS, LONG, RISK, SODS
OGLE: LEER, TWIT
OGRE: CAVE, GRIM, LAIR
OILY: COAT, HAIR, MESS, ROAD, SHIP, SICK, SKID, SKIN, SUMP, SWAN
OINK: PIGS, SEAL
OKAY: CAST
OMEN: AMEN
OMIT: DENY, MISS, NONE, SKIP, SNUB, WORD
ONCE: ERGO, JUST, KNEW, MORE, ONLY, PAST, RARE, SAID, THEN, TIME, UPON, USED, WERE
ONES: DEAR, MINE, SNOB, SOME, TOES, TWOS
ONLY: ALSO, EVER, EXIT, FOUR, JUST, LONE, MINE, NONE, ONCE, ONYX, RARE, SLOE, SOLE, SOME, THEE, WERE, WHAT, WHEN
ONTO: INTO, POUR, WELD
ONUS: DUTY
ONYX: DEER, GOLD, JADE, NAIL, ONLY, ONYX, RING
OOPS: BOOB, BURP, DROP, FALL, HELP, LATE, OUCH, SHIP, SLIP
OOZE: BOIL, MELT, SEEP
OPAL: MINT
OPEN: AIRY, AJAR, BARE, BARS, BOAT, BOOK, CAMP, CANS, CASE, CAVE, DOOR, EXIT, EYES, FILE, FIRE, FLAP, FREE, FULL, GATE, GLAD, HELD, KEYS, LEGS, MOOR, NAPE, OVEN, PARK, PUSH, SAFE, SEAL, SHOP, SHUT, SOFT, TEAR, WIDE, WILD, YAWN
ORAL: ANAL, DEAF, EXAM, LIPS, LOVE, OVAL, PILL, TALK, TEST
OREE: JAMB
ORGY: TOGA
OTIS: LIFT, SONG, SOUL
OUCH: ACHE, BUMP, BURN, CANE, CUTS, FALL, GOSH, GULP, HEAD, HELL, HURT, ITCH, JAMB, JERK, KICK, OOPS, PAIN, PINS, RAIN, SOAR, SORE, WHAM, WHIP, YELL
OURS: BABY, CAMP, DAYS, DOGS, HAVE, HOME, LAND, LOVE, MINE, OURS, POPE, WIFE, YEAR, YOUR
OVAL: ORAL, ROOM
OVEN: BAKE, BIRD, BUNS, BURN, CAKE, COKE, COOK, DISH, DOOR, FIRE, FOOD, HEAT, JEWS, LAKE, LAMB, MILK, OPEN, RING, WARM
OVER: AMEN, ARCH, BEND, BIND, BOIL, BOWL, BRIM, CAME, COAT, COIN, COME, DONE, DOSE, FELL, FLAP, FLIP, FOLD, GAME, GIVE, GLAD, GONE, HANG, HELD, HERE, HILL, INCH, INTO, JUMP, LEAN, LEFT, LENT, LOOK, LOOM, LORD, MOON, MORE, MOVE, NAZI, OVER, PASS, PAST, PULL, PUSH, REEL, REST, RIPE, RISE, RODE, ROLL, RULE, SEAS, SEER, SLIP, SNUG, SOON, STEP, TAKE, TILT, TIME, TOOK, TRIP, TURN, UPON, WALK, WALL, WIPE, YEAR
OWED: BANK, BILL, DEBT, FINE, LENT, LIFE, LOAN, LOTS, MINE, OWEN, PAID, POEM, TRUE
OWEN: ALAN, MIKE, OWED, SUCH
OWES: DEBT
OWLS: BATS
OXEN: YOLK
OZZY: IZZY
PACE: EVEN, FACE, FAST, FEET, FOOT, LACK, MAKE, PATE, RACE, RATE, RUSH, SLOW, STEP, STOP, TIME, WALK, WORK
PACK: BACK, BAGS, CARD, CUBS, DEAL, DECK, FACE, FOOD, HOME, LIES, LOAD, MEAL, MULE, SACK, WALK, WOLF, WOOL, WRAP, YELL
PADS: PAWS
PAGE: BOOK, FOLD, LAST, LEAF, LONG, MOSS, NOTE, PULL, RAGE, READ, SERF, STOP, TEXT, TURN, WORD
PAID: BILL, CASH, DEBT, DONE, EARN, FEED, FREE, FULL, OWED, RENT, RICH, WAGE, WORK
PAIL: AWAY, BOAT, HOLE, JACK, LINO, MILK, MOON, MOPS, PAIN, PALE
PAIN: ACHE, BACK, BEAR, BEAT, BELT, BITE, BOIL, BUMP, BURN, CANE, CHAP, CURE, CUTS, DIGS, DRUG, EASE, FALL, FEAR, FEEL, FELL, FELT, FLOG, FOUR, FULL, GASH, GASP, GRIP, HARM, HATE, HEAD, HURT, ILLS, JAZZ, JERK, JOLT, KICK, KILL, LANE, LASH, LIMP, LUST, MILD, MIND, MOAN, NAZI, NECK, OUCH, PAIL, PANE, PANG, PILE, PINS, PULL, RACK, RAPE, SEER, SICK, SORE, SOUR, STAB, STOP, TOES, TOIL, VAIN, WALK, WANE, WASP, WHIP, YELL
PAIR: BOTH, EYES, KIND, LEGS, MATE, PEAR, TITS, TRIO, TWIN
PALE: ALES, BEER, BLUE, DARK, FACE, JACK, LOST, MAIL, MALE, PAIL, SATE, SICK, THIN, VEAL, WANE, WEAK
PALM: ARAB, DATE, HAND, LEAF, TIPS, TREE
PALS: BUDS
PANE: BALL, HURT, PAIN, SHAM
PANG: ACHE, BANG, FEAR, HOME, HURT, LONG, LUST, PAIN, PANG, PING, PONG, RING, STAB
PANS: BINS, CANS, COOK, CUPS, DISH, DUST, FOOD, GOLD, HARD, LIDS, POTS, SINK
PANT: FIRE, FOOL, GASP, HARD, HART, HUFF, HUNT, MOAN, PUFF, RACE, RANT, REST, SIGH
PARK: CARS, DEER, EDEN, FINE, GAME, GATE, HERE, HIDE, HOME, HYDE, INCH, LAND, LANE, MAZE, MEET, OARS, OPEN, PEEL, PLAY, POND, ROOM, SEAT, STOP, TREE, UNIT, VALE, VIEW, WALK
PART: CAKE, DEMI, DROP, EACH, FART, HAIR, HALF, INCH, LIFE, MEET, PLAY, SECT, SEMI, SOME, TAKE, TEAR, TIME, TOOK, WAYS
PASS: DROP, EDIT, EXAM, FAIL, FALL, FREE, FROM, GALE, HOPE, KISS, LIST, LOSE, LUCK, MARK, MORE, OVER, PAST, SIGN, SNOG, SNUB, STOP, TEST, TIME, VISA, WORD
PAST: ABEL, AGES, BACK, BEEN, CAST, DAYS, DONE, EYES, FIVE, GONE, GREY, HALF, KNEW, LAST, LEAK, LIFE, MISS, NINE, ONCE, OVER, PASS, PUSH, RODE, SIGN, SINS, TIME, WERE, WHEN
PATE: BALD, BOLD, BROW, DATE, FATE, FISH, FOOD, HEAD, JOHN, MATE, MEAT, NICE, NUTS, PACE, RATE, SATE, WHAT
PATH: ALLY, EASY, FLOW, FOOT, GATE, HILL, LANE, MAZE, ROAD, SLAB, TRAY, WALK, WAYS, WIND, WOOD
PAUL: COOK, DOME, HERE, KANE, LIPS, MONK, NAME, POPE, RAVE, WENT, WOGS
PAWN: DAME
PAWS: BEAR, CATS, CUBS, DOGS, FEET, GRIP, HAND, LUCK, PADS, STOP, TAIL
PAYS: HERO
PEAK: APEX, BASE, CRAG, DALE, HILL, HOUR, NOSE, NOSY, TIME, WIND, WOOD
PEAL: DEAL
PEAR: CORE, DROP, EDAM, LOBE, LOOK, PAIR, PLUM, RIPE, SOAP, SOFT, TEAR, TREE, WEAR
PEAS: ANTS, BEAN, BOIL, CANS, FOOT, GROW, MINT, NUTS, PIES, PISS, PODS, RIPE, SHOD, SOUP, WORM
PEAT: FUEL, MOOR, MOSS
PECK: BEAK, BILL, BIRD, BITE, DECK, FEED, GILL, HECK, HENS, HOLE, HURT, JUMP, KISS, NECK, PICK, TAKE, TREE
PEEK: MICK
PEEL: CORE, EMMA, JOHN, PARK, SKIN, SPUD, TYRE
PEEP: HONK, JEEP, PEER, SEEP
PEER: BEER, DUKE, EARL, FOOL, GAZE, GYNT, HIGH, KING, LADY, LEER, LIFE, LOOK, LORD, PEEP, PINT, SCAN, SEER, SHIP, TORY
PEGS: DOLL, FEET, LEGS, LINE, PODS, RATE, ROPE, TENT, WALL, WOOD
PENS: HUTS, TIPS
PERM: WAVY
PERU: INCA
PEST: BORE, BRAT, BUGS, EVIL, FLEA, FOUL, FOWL, GOSH, KILL, LEST, LIAR, MICE, MOTH, SIDE, WORK
PETE: ARCH, BEST, BILL, BRUM, COMA, MIKE, RASH, SAKE, SLOB, TONE
PETS: CATS, DOGS, FOOD, HATE, KEEP, MICE, NICE, PETS, POTS, TOYS, WARM
PHEW: GOSH, SIGH
PHIL: PUKE
PICK: CROP, DROP, HOLD, HOME, HOPS, LICK, LIFT, LOCK, NOSE, PECK, SKIN, TAKE, WICK
PIED: PIER
PIER: BOAT, FISH, HEAD, LONG, LOOK, LORD, LOVE, MASS, PIED, QUAY, SHIP, WALK
PIES: BAKE, CAFE, FACE, FOOD, MEAT, PEAS, PORK, PUBS
PIGS: BORE, CATS, COPS, COWS, DIRT, DOGS, DUNG, EATS, FARM, FEED, FEET, FIGS, FOOD, FUZZ, HAMS, HOGS, LARD, MUCK, OINK, PINK, POKE, PORK, SHIT, STYE, SWIM, TROT, WIGS
PIKE: DIKE, PUKE
PILE: ANUS, BILE, DIRT, DUNG, FALL, FOOD, HEAP, HIGH, JUNK, LOAD, LOGS, LOTS, LUMP, MUCK, PAIN, POLL, RAGS, REED, SAND, SHIT, SORE, WOOD
PILL: BABY, CHAP, COIL, DOSE, DRUG, GILL, LOOP, ORAL, PILL, POOL, POPE, SAFE, SICK, STOP, TAKE
PIMP: LIMP, PUMP
PINE: AWAY, BATH, CONE, FIRS, FRET, HOWL, LOGS, LONG, MISS, TALL, TREE, WEEP, WINE, WOOD, WORD
PING: BALL, BELL, DING, LING, PANG, PONG, TING, TONG
PINK: BABY, BLUE, CHIN, CUNT, DAWN, FOOT, GILL, GIRL, GRAY, GREY, GRIN, GUMS, HAMS, LACY, LILY, LIPS, PIGS, PONY, PUNK, RINK, ROCK, ROOM, ROSE, SKIN, VEAL, WARM, WINK
PINS: BOWL, HATS, HURT, NECK, NINE, OUCH, PAIN
PINT: AJAR, BEER, BRIM, BYRE, FULL, GILL, GULP, HALF, MILK, PEER, PLAY, PULL, SIZE, THIS
PIPE: BEND, BENT, BLOW, BOWL, CLAY, DRUM, FLOE, FLOW, FLUE, FUME, HASH, HOLE, HORN, HOSE, LEAD, LEAK, LEEK, LINE, LONG, MAIN, PLAY, POND, REED, STEM, THIN, TOOL, TUBE, TUNE, WIND
PIPS: FIGS, HIPS, NEWS, PONG, POPS, ROME, SPIT, TIME
PISH: SHIT
PISS: COMA, HISS, KNOB, LEAK, LEEK, MICK, PEAS, PUSS, SHIT, SLOE, SPEW
PIST: CYST, MIST
PITS: SITS
PITT: BING, COAL, CORN, DEEP, EDEN, FALL, GAME, HOLE, MINE, WITS
PITY: ALAS, DARE, DUMB, EYES, FEAR, FEEL, GULF, HARD, HATE, HOPE, HURT, LOVE, MOCK, NONE, PLEA, POOR, SAKE, SELF, SICK, TEAR, WEPT
PLAN: AREA, CITY, FILE, HOPE, IDEA, MAKE, MEET, PLOT, SHOT, SITE, STUD, TICK, TOTE, TOWN, VIEW
PLAY: ACTS, AIRY, AREA, BACH, BACK, BALL, BAND, BOMB, BOOK, CAME, CARD, CAST, CLAY, CLUB, DEAL, DICE, DISC, DOLL, FAIR, FALL, FILM, FOAL, FOOL, FOUL, FOWL, GAME, GOLF, GOOD, HIGH, HOOP, IDLE, JAZZ, JEST, KIDS, LINO, LOVE, MASK, MATE, MIME, NINE, PARK, PART, PINT, PIPE, PLOT, POEM, ROOM, SAFE, SEEN, SHAM, SHOW, SKIP, SKIT, TEAM, TIME, TOYS, TUBA, TUNE, WORK, YARD
PLEA: PITY
PLEB: BRAT
PLOP: DRIP, FLAP, HISS
PLOT: BAND, BLOT, GAME, KILL, LAND, MASK, PLAN, PLAY, SITE, TRAP, TREE
PLUG: BATH, CORK, EARS, FIRE, FLOW, FLUX, HAIR, HOLE, JACK, LAMP, LEAD, LEAK, MAIN, MOLE, PULL, PUSH, SINK, STOP, UGLY, WIRE
PLUM: CAKE, CHUM, DUFF, GIRL, LEAD, LIMY, PEAR, RIPE, STEW, TART, TREE
PLUS: LESS, SUMS
PODS: PEAS, PEGS
POEM: AFAR, ANON, BASE, BOOK, DRAG, DULL, EPIC, LOVE, OWED, PLAY, POET, READ, ROSE, SAGA, SCAN, SONG, WORK
POET: ANON, ARTS, BARD, BOOK, BUMS, GOOD, HAIR, LOVE, NONE, POEM, POET, SING, SONG
POKE: COAL, FIRE, FOLK, FUCK, FURS, HOLE, JERK, JOKE, NOSE, PIGS, PROD, PULL, PUSH, STAB, WANE
POLE: AXIS, BEAN, BEAR, BUNT, COLD, FLAG, LINE, MAST, PROD, RAKE, ROLL, STAR, TALL, TENT, TREK, TUBE, WEST
POLL: BIRD, DEED, HEAD, HORN, MOLL, NECK, PILE, THIS, TORY, VOTE, WIND
POLO: DUKE, FOOT, HOLE, LAME, MARK, MINT, MOON, NECK, PONY
POMP: DEAN, KING, POMP, POOF, PUMP
POND: BACK, BOAT, CALM, DEEP, DUCK, FALL, FISH, FLAT, FROG, LAKE, LIFE, LILY, MILL, MIRE, NEWT, PARK, PIPE, POOL, SILL, SLIM, SWAN, WEED, WELL
PONG: DONG, FART, HONG, PANG, PING, PIPS, WONG
PONY: CLUB, FOAL, GIRL, HACK, JOLT, KICK, MANE, OATS, PINK, POLO, RIDE, SALE, SHOD, TAIL, TRAP, TREK, TROT
POOF: CAMP, POMP, PUFF, VAIN
POOH: APEX
POOL: DEEP, DIVE, FISH, FROG, LILY, NEWT, PILL, POND, REED, ROCK, ROOM, SMOG, SNAP, SWIM
POOP: DECK, INCA
POOR: AGED, ALAS, DIME, DRIP, FOLK, GREY, GRIM, HACK, LACK, LAME, MEAN, MEEK, MISS, NEED, PITY, RAGS, RICH, ROTE, SERF, SHAM, SOUL, WEAK, WELL
POPE: BORE, BOSS, FOOL, FUCK, HATE, HOLY, JOHN, LOPE, MONK, NUTS, OURS, PAUL, PILL, RICH, ROBE, ROME, TWIT
POPS: BANG, CORN, GUNS, HOPS, PIPS, SNAP, SONG, STAR, TITS, TOPS
PORE: LEAR
PORK: BEEF, BONE, CHOP, DEAD, FOOD, HAMS, HORN, MEAT, PIES, PIGS, RIBS, SOUR, VEAL
PORT: BOAT, CALL, DEAL, DOCK, HOLE, LAST, LEFT, SAID, SHIP, SIDE, VALE, WINE, WING
POSE: FACE, NOSE, NUDE, RUDE, SHOW
POSH: AREA, DICK, DULL, FOOD, GOLF, GOSH, LADY, NAME, POSH, PUSH, RICH, SHOP, SNOB, SUIT, TOFF, VERY
POST: ANTE, BENT, BILL, CARD, DEAF, DOOR, FILE, GAOL, GATE, GOAL, HORN, JAMB, LAMP, LEAN, MAIL, MILE, MOST, RACE, SEND, SENT, SIGN, SINE
POSY: NOSY
POTS: CLAY, CUPS, DRUG, FEET, LIDS, PANS, PETS, SHIT, SINK, STOP, WARE
POUR: BEER, DRIP, FILL, FLOW, INTO, MELT, MILK, ONTO, RAIN, SEEP, SOAK, SORE, VOUS, WINE, WITH
PRAM: BABY, BIKE, DOLL, HOOD, KIDS, PUSH
PRAY: BOOK, DAFT, FOOD, FOUL, HARD, HELP, HOPE, LAUD, LOVE, MASS, MONK, PREY, TALK
PREY: BIRD, FOOD, FOOL, GREY, HAWK, HIDE, HUNT, KILL, KITE, LION, PRAY, SPIT, WOLF
PRIG: SNOB
PRIM: NEAT
PROD: KICK, POKE, POLE, PUSH
PROW: BEAM, BOAT, BOWS, BROW, CROW, DARK, FOAM, GOOD, HULL, JUMP, LOOK, NOSE, REAR, SHIP, STEM
PSST: SSSH
PUBS: ALES, ARMS, BARS, PIES
PUCK: DISK, FUCK
PUFF: BLEW, BLOW, CAMP, DUFF, GASP, HISS, HUFF, PANT, POOF, PUFF, SNOB, WIND
PUKE: BILE, BOAK, BOKE, DUKE, FART, FOOD, FOOL, HATE, HAWK, HONK, JOKE, JUST, MESS, PHIL, PIKE, SICK, SILK, SPEW, SPOT, YAWN
PULL: AWAY, BACK, BELL, CORD, CREW, DOOR, DOWN, DRAG, DRAW, FACE, GRAB, HALL, HARD, JERK, LIFT, NOSE, OVER, PAGE, PAIN, PINT, PLUG, POKE, PUSH, ROPE, SWAY, TAIL, TAKE, TEAR, THIS, YANK
PULP: BALL, FINE, GULP, MASH, MESS, MILL, TREE, WOOD, WORD
PUMP: BIKE, BOOT, BUMP, DUMP, ESSO, FART, FIRE, FLOG, FOOT, FUEL, PIMP, POMP, SEEP, SHOE, TYRE, YARD
PUNK: PINK, SLOB
PUNY: WEAK
PUPS: CUBS
PURE: ABLE, ADAM, CURE, DEAD, EVIL, FLOW, FOOL, GOLD, GOOD, HOLY, MILK, NUDE, RARE, ROCK, SILK, SNOW, SOUL, SURE
PURL: KNIT
PURR: HISS
PUSH: BIKE, CANT, DOOR, FAGS, FALL, FEND, FRAY, GRAB, HARD, HELP, HUFF, JERK, JOLT, KICK, LIFT, MOVE, OPEN, OVER, PAST, PLUG, POKE, POSH, PRAM, PROD, PULL, RISK, RUSH, TOSS, URGE
PUSS: BOIL, BOOT, BUMP, CYST, FACE, GIRL, MUCK, PISS, PUSS, SOFT, SORE, SOUR, YANK
PUTT: SHOT
QUAG: MIRE
QUAY: DELL, PIER, TORE
QUID: CASH, DEAL, FOOD, MORE, NOTE, WHAT
QUIP: JEST
QUIZ: BALL, BOOK, GAME, KIDS, SHOW, TEAM, TEST, THIS, TIME, WALL, WHAT, WORD
RACE: ARMS, BASE, BOAT, CARS, CAST, DASH, DRAG, FLEE, GANG, GASP, IDLE, IDOL, LACE, MARX, MEET, MILE, MILL, MORE, PACE, PANT, POST, RIOT, RUSH, SACK, SECT, TAPE, TEAM, TIME, TROT, WOGS
RACK: BACK, BOMB, BOOK, CASE, COAT, DOWN, PAIN, RAIL, RICK, ROOF, RUIN, SHOE, WINE
RACY: LACY, ROME
RAFT: DAFT, TYRE
RAGE: BEAR, CALM, FEAR, FITS, FLAP, FUME, FURY, HATE, KILL, LION, PAGE, RAGE, RANT, RIFE, ROAR, SHAM
RAGS: BAGS, BONE, CART, DIRT, DOLL, GLAD, IRON, JEWS, PILE, POOR, TAGS, TOGS, TORN, WOOL
RAID: BANK, BOMB, BUST, DRUG, FUZZ, GRAB, GUNS, LOOT, MAID, READ, THEM
RAIL: FILE, IRON, LATE, LINE, LIVE, RACK, ROAD, SLOW, WAYS
RAIN: CAME, CAPE, COLD, COOL, CROP, DAMP, DEAR, DOWN, DRIP, DROP, DULL, FALL, FINE, FIRS, GALE, GASP, GAVE, GREY, GROW, HAIL, HARD, HELL, HOOD, JULY, LEAK, LOVE, MILE, MIST, MOOR, OUCH, POUR, RASH, RIPE, ROOF, SNOW, SOAK, TAXI, TENT, TOGS, UPON, WIND
RAKE: BAKE, BEAU, CAKE, COMB, FAKE, FORK, HARD, JAKE, MAKE, MUCK, POLE, RISE, ROOK, SAKE, SLIM, SOIL, THIN, TOOL, WORK
RAMS: EWES
RANG: BELL, DANG, DOOR, GOON, HARD, LOUD, RING, RUNG, TANG
RANK: ARMY, DANK, FILE, FILM, GONG, HIGH, NAME, NAVY, RATE, RINK, RULE, TANK, TAXI
RANT: PANT, RAGE, RARE, RAVE, REED, ROAR, ROVE, RUNT
RAPE: BARN, FEAR, FUCK, GIRL, GOOD, HAIR, HELL, HELP, JAIL, JAPE, KNOB, LOCK, LOOT, LUST, NAPE, NEWS, PAIN, RAPE, REAP, RIPE, ROPE, SEED, SHAG, SOIL, TAPE, YELL
RARE: BIRD, FINE, FISH, GOOD, MEAT, ONCE, ONLY, PURE, RANT, REAL, RIFE, TRAP, WINS
RASH: ACNE, DASH, FACE, FAST, FOOL, HAND, HARD, IDLE, ITCH, MESS, PETE, RAIN, SKIN, SORE, SPOT
RASP: CANE, FART, FILE, FIRM, GASH, GASP, GRAB, HARD, HISS, LIPS, MASK, NOTE, RASP, RUDE, SORE, WASP, WOOD, YELL
RATE: BANK, DULL, FAIL, FALL, FAST, FORM, GIRL, HARD, HIGH, MATE, PACE, PATE, PEGS, RANK, SATE, SLOW, TIME, WAGE, WORK
RATS: BAGS, BARN, BATS, BITE, CATS, DIRT, DOGS, EATS, HASH, JEWS, LICE, MAZE, MICE, SHIP, TRAP, WOOD
RAVE: BEAT, CANT, DAVE, DAZE, GOES, HIGH, JIVE, KICK, PAUL, RANT, RIFE, RIOT, RUIN, WILD
RAYS: BEAM, FINS, FISH
READ: BOOK, EDIT, FAST, LIPS, LOOK, LOUD, MUCH, NOTE, PAGE, POEM, RAID, REED, ROTE, TACK, TALK, TEXT, THIS, WELL, WORD
REAL: COOL, FAKE, GOOD, LIFE, LIVE, RARE, SURE, TRUE, WHAT, WOGS
REAP: CORN, OATS, RAPE
REAR: ANUS, ARSE, BACK, BULL, DOOR, FEED, FORE, HIND, MAIN, PROW, SEAT, VIEW, WEAR
REDS: CUTS
REED: BANK, BEND, BLOW, BOOK, CONE, FISH, HUTS, LAKE, NEED, OBOE, PILE, PIPE, POOL, RANT, READ, RUSH, SHOP, WEED, WIND, WOOD
REEF: KNOT
REEL: FALL, FILM, FISH, HOOK, HOSE, LINE, LIST, NEWS, OVER, RIDE, ROCK, SAME, SPIN, SPUN, TURN
REES: SMOG
REIN: NIGH, WHIP
REND: TORE, TORN
RENT: BENT, BIRD, BOOK, FLAT, FREE, HIGH, HIRE, LAND, PAID, TEAR, TENT, TORN
REST: BEDS, CAMP, CHIN, CURE, DOZE, EASE, HEAD, HOME, KNEE, LAID, MASS, MEAL, MIND, NEST, OVER, PANT, ROOM, RULE, SEAT, SEEP, SITS, SSSH, STAY, STOP, TIME, TIRE, TOIL, WISH, WORK
RIBS: ADAM, BACK, BEEF, BOAT, BODY, BONE, CAGE, CASE, FALL, MEAT, PORK, THIN
RICE: BOIL, BOWL, CHOP, COOK, FOOD, HASH, LICE, MAZE, NICE, OATS, SAGA, SAGO, SAIL, SAKE, VICE
RICH: BABY, CAKE, COIN, DEAD, EARL, FINE, FOLK, FOOD, GOLD, GROW, IDLE, IDOL, MINK, PAID, POOR, POPE, POSH, WARY, WEAK
RICK: HICK, RACK
RIDE: AWAY, BIKE, BOAT, CART, FALL, FUCK, HARD, HIDE, HIGH, JUMP, PONY, REEL, RODE, SAIL, SHIT, SLAY, SPIN, TAXI, WALK
RIFE: FULL, HAVE, KILL, LIFE, LOTS, RAGE, RARE, RAVE, RIFT, RIPE, WILD
RIFT: RIFE
RING: ABEL, ANUS, AREA, BAND, BELL, BOUT, BULL, COIF, COIL, DING, DISK, DOOR, DOVE, DOWN, ECHO, GIFT, GOLD, GONG, HAND, HOOP, KEYS, LING, LOOP, LORD, LOST, LOVE, ONYX, OVEN, PANG, RANG, RUNG, SEAL, SING, SONG, TING, TRUE, VICE, WEAR, WORM
RINK: PINK, RANK, SINK
RIOT: AMOK, FRAY, MASS, NEWS, RACE, RAVE, ROAR
RIPE: CORN, FIRM, GOOD, KEPT, OVER, PEAR, PEAS, PLUM, RAIN, RAPE, RIFE, SOFT, SOUR, TIME
RIPS: TORE
RISE: BOSS, BROW, CAKE, FALL, FOOL, LIFT, LUMP, OVER, RAKE, SINK, SOAR, TIME, TORE, WAGE, WAKE, WANE
RISK: BABY, CARE, DARE, FAKE, FIRE, GAME, HIRE, HOPE, LIFE, LOSS, LOVE, NONE, ODDS, PUSH, SAFE, TAKE, TASK
RITA: MAID
ROAD: ALLY, ARCH, AREA, BEND, BUMP, BUSY, CARE, CARS, CITY, DIGS, DUST, ELMS, ENDS, FOOT, FORK, GREY, GRIP, HALT, HIGH, HIKE, HILL, HOLE, HURT, KERB, KING, LANE, LEAF, LINK, LONG, LUMP, MAIN, MILE, MODE, OILY, PATH, RAIL, SAFE, SIDE, SIGN, STOP, TAXI, TIRE, TOLL, TURN, WALK, WIDE
ROAM: FOAM, FREE, HOME, INTO, ROME, ROMP, TONY, WALK, WIDE, WILD
ROAR: BARK, BARS, BULL, CORE, GLEE, HIGH, HOAR, HOWL, LION, LOUD, MOAN, RAGE, RANT, RIOT, WAIL, YELL
ROBE: BATH, BORE, CAPE, COAT, GIVE, GOWN, JOKE, KING, LONG, MINE, MONK, POPE, SARI, TENT, TOGA, WARD, WEAR
ROCK: AGES, APES, BABY, BANG, BASE, BASS, BOAT, CAKE, CAVE, COVE, CRAG, CRIB, DISC, DOME, ECHO, FACE, FALL, FOLK, FORT, HARD, HEWN, HILL, INCH, JAZZ, JIVE, MOSS, PINK, POOL, PURE, REEL, ROLL, RUIN, SALT, SEEP, SHAM, SHIP, SLAB, SOUR, SUCK, SWAY, TACK, TICK, TIDE, TILT, TIME, TORE
RODE: AWAY, BIKE, OVER, PAST, RIDE, RODE, UPON
RODS: BARS, CONE
ROLL: AWAY, BALL, BANG, BRUM, CAKE, CALL, DAZE, DOWN, DRUM, FALL, FIGS, FOIL, HAIR, JIVE, LEER, OVER, POLE, ROCK, RULE, SUET, TILT, TURN, WRAP
ROME: AWAY, CITY, DOME, FIRE, HOLY, NERO, PIPS, POPE, RACY, ROAM, RUIN, TOGA, TOWN, WINE
ROMP: ROAM
ROOF: BEAM, DOME, EWES, FELT, FLAT, GLOW, HEAD, HIGH, HUTS, LEAD, LOFT, MOSS, RACK, RAIN, TILE, TILT, TOPS, TUBA, WALL
ROOK: CROW, HAWK, RAKE
ROOM: AIRY, ANTE, AVON, BACK, BALL, BATH, BOOM, BUNS, CELL, CLUB, COLD, COSY, COZY, CROW, CUBE, DAMP, DARK, DIGS, DOOR, DRAB, EXAM, FLAT, FORM, FULL, HALL, HOME, INTO, LAIR, LESS, MATE, MESS, MOON, MOOR, MOVE, NEWS, OVAL, PARK, PINK, PLAY, POOL, REST, SOFA, TIDY, VIEW, WALL, WARD, WOOD
ROOT: APEX, BEER, BEET, BOOT, CLUB, COIL, CORE, CROP, CUBE, DEEP, EVIL, FIND, FOOT, GROW, GRUB, HAIR, HEEL, LEAF, MOOT, NOSE, SOIL, STEM, TILE, TOOT, TREE, TUBA, WALK
ROPE: BELL, BIND, BOND, COIL, CORD, CREW, DRAG, ENDS, FLOG, FRAY, HAND, HANG, HARD, HEMP, HOSE, HUSH, JUMP, KNOT, LOOP, LOPE, MORE, NECK, PEGS, PULL, RAPE, ROTE, SHIP, SINK, SKIP, TENT, TIED, TOGS, WALK, WHIP, WIRE, WORK, YARN
ROSE: BUDS, BURN, BUSH, DOZE, FACE, FAIR, FROM, GREW, HIPS, HOPE, JANE, LANE, LEAF, LILY, LOVE, MARY, PINK, POEM, SANK, STEM, TREE, VINE, WINE, YORK
ROSY: DAWN, LACY
ROTA: LIST
ROTE: LIST, NOTE, POOR, READ, ROPE, TATE, TOTE, TURN, VOTE, WHAT
ROUT: BAWL
ROVE: RANT
RUBY: DIME
RUDE: ANUS, ARSE, BURP, CRAP, FART, FUCK, GRAB, NOSY, NUDE, POSE, RASP, SINE, SKIT, SNUB, TUBA
RUIN: BATS, DEAD, DOOM, FALL, MEND, MESS, RACK, RAVE, ROCK, ROME, SITE
RULE: BOOK, DOWN, FOOL, FOOT, GAME, HALL, HOME, INCH, IRON, KANE, KING, LINE, NONE, OBEY, OVER, RANK, REST, ROLL, SINE, TALK, WOOD
RUMP: ARSE, KIRK, SIDE
RUNG: BELL, DONE, HUNG, NECK, RANG, RING, STEP
RUNS: GOES
RUNT: BUNT, RANT
RUSH: AWAY, BACK, BULL, BUSH, BUSY, COUP, DART, DASH, DAWN, FALL, FAST, FLOW, GOLD, HECK, HOUR, INTO, MANY, PACE, PUSH, RACE, REED, STOP, TUBE
RUST: BIKE, BODY, DIRT, IRON, NAIL, WORN
RUTH: BABE, DAME
RYAN: ALAN
SACK: BACK, BAGS, BUST, COAL, DOLE, FIRE, HEMP, LOAD, LOSE, LUNG, MALT, OATS, PACK, RACE, SOCK, WOOL, WORK
SADE: WHIP
SAFE: AMOK, BANK, DARE, EGGS, FAIL, FIRM, GLAD, HERE, HOME, KEEP, LOCK, LOVE, NICE, OPEN, PILL, PLAY, RISK, ROAD, SAGA, SUNG, SURE
SAGA: DATE, EPIC, FARE, FISH, KING, MORE, POEM, RICE, SAFE, SAGE, SAGO, SALT, SHIP, TALE, TELL
SAGE: SAGA, SEER, WISE
SAGO: RICE, SAGA
SAID: DEED, DONE, GLUM, JEST, JOHN, KING, KNEW, LIAR, LOUD, ONCE, PORT, SAYS, TALK, THAT, THIS, TOLD, WHAT, WHOM, WORD
SAIL: AHOY, AWAY, BENT, BLUE, BOAT, BOUT, CAMP, CLUB, FISH, FLAP, INTO, JAMB, JOIN, MAIN, MAST, RICE, RIDE, SANK, SEAS, SHIP, TACK, TALE, TRIM, WIND
SAKE: CARE, FAKE, FORE, GODS, HELP, KEEP, LIFE, LOVE, MINE, NAME, PETE, PITY, RAKE, RICE, SELF, SLAB, SOUL, TIME, WINE, YOUR
SALE: BOAT, FREE, GALA, GONE, HATS, HEAL, MALE, PONY, SALT, SELL, SHOP, SOLD, SOLE, WORK
SALT: ACID, CUBE, FOOD, LOTS, MALT, MELT, MINE, NUTS, ROCK, SAGA, SALE, SAND, SEAS, SILO, SLUG, SOUR, TANG, WORK
SAME: BALL, BODY, BOTH, EVEN, FACE, GAME, JUST, LAME, LIKE, NAME, REEL, TIME, TWIN
SAND: ARID, BANK, CLAY, COSH, COVE, DUNE, DUST, FOAM, GIRL, GOLF, GRIT, HILL, HOUR, IRON, JUNE, LIME, LOAD, PILE, SALT, SEAS, SNOW, TENT, THOU, TIME, WARM
SANE: BENT, DULL, MADE, MIND, STAY, WISE
SANK: BOAT, DOWN, FELL, GONE, LEAD, ROSE, SAIL, SHIP, SINK, SUNK, SWAM, SWIM
SARA: SARI
SARI: EAST, GIRL, GOWN, LONG, ROBE, SARA, SILK, TOGA, VEIL
SARK: DAME, NOAH
SASH: BAND, BELL, BELT, BLUE, CASH, CORD, LOUD, SEIK, SILK, SONG, WHIP
SATE: BAIT, DOWN, FOOD, FULL, GATE, HATE, LADY, LATE, MATE, MEAL, NUTS, PALE, PATE, RATE, SEED
SAUL: ABEL
SAVE: BANK, CALL, CURE, DARN, EARN, FACE, FEND, FROM, GAVE, GIVE, GOAL, GOOD, HEAL, HELP, KEEP, KILL, LIFE, LOSE, SEND, SOUL, SURE, TIME
SAYS: SAID
SCAB: CYST, HEAL, SCAR, SORE
SCAN: PEER, POEM, SPAN
SCAR: BURN, CRAG, FACE, FELL, HILL, HIRE, HURT, KNEE, LEGS, MARK, MESS, SCAB, SORE, UGLY, WORK
SCOT: GRAB, KILT, OATS
SCUM: BATH, CAKE, DIET, DIRT, FOAM, GREY, MUCH, MUCK, SINK, SLUM, SOAP, SOUP, SURF
SEAL: DEED, EYES, FISH, KING, KISS, LICK, LION, LOCK, MARK, MEAT, OINK, OPEN, RING, SHIP, SKIN, SOLD
SEAM: COAL, DEAL
SEAS: BALE, BLUE, CALM, DEEP, FISH, HIGH, OVER, SAIL, SALT, SAND, SHIP, SURF, SWIM, TIDE, WAVY, WIND
SEAT: ALES, ARSE, BACK, BANK, BEAT, BEEF, BELT, CHAR, COLD, COZY, DESK, FORM, FRED, HARD, PARK, REAR, REST, SIDE, SITS, SOFA, WOOD
SECT: CANT, CART, CAST, CLAN, COUP, CULT, JEWS, NUTS, PART, RACE, SIDE
SEED: BEAN, BIRD, CAKE, CORN, CROP, FEED, GROW, HEMP, LAWN, LEAF, LIFE, MAZE, RAPE, SATE, SOIL, SOWN, TIME, TOME, VAIN, WEED, WIND
SEEK: FIND, HIDE, HUNT, KILL, LIFE, LOOK, LOST, SONG, THEE, WHAT
SEEM: DOOR, EASY, KNOW, LIKE, LOOK, NEAR, THEM, WHAT
SEEN: BEEN, BOAT, EYES, FILM, GONE, KEEN, LAST, PLAY, SHOW, THIS, WHAT, WHEN
SEEP: DAMP, DEEP, DOWN, DOZE, DRIP, FLOW, HOLE, INTO, LEAK, LEEK, LISP, OOZE, PEEP, POUR, PUMP, REST, ROCK, SINK, SOAK
SEER: BEER, BURN, CRAP, DEER, DOER, DOOR, EYES, FALL, HEAT, LAND, LIAR, LORD, MAGI, MURK, OVER, PAIN, PEER, SAGE, SEER, SOAR, WHIP, WISE
SEIK: SASH
SELF: DUTY, ELSE, FEND, GRAB, HELP, HOME, IDLE, KEEP, LAZY, LONE, MADE, NAME, NICE, PITY, SAKE, SHIT, SLOB, THIS, YOUR
SELL: EDAM, FAST, FISH, FLOG, FOOD, GEAR, HAWK, HIRE, MORE, MOST, SALE, SHOP, SOLD, TAPE, VIEW, WARE, WELL
SEMI: DEMI, HALE, HALF, HALT, NUDE, PART, TONE
SEND: AWAY, BACK, GAVE, GIVE, GONE, GRIP, HOME, MAIL, MEND, POST, SAVE, SENT, SHIP, SOME, TAKE, UNTO
SENT: AWAY, BENT, CAME, DOWN, FROM, GAVE, GONE, HERE, HOME, LEFT, MIND, POST, SEND, WENT
SERF: BOSS, LAID, LORD, PAGE, POOR, SOIL, WAVE
SETS: BARS, TWIN
SEXY: BIRD, BLUE, FILM, GALE, GIRL, GOOD, HIPS, LACY, LEGS, LOOK, LOVE, SLIM, WHAT, WIFE
SHAG: FUCK, RAPE
SHAM: FACE, FAKE, HIDE, MOCK, PANE, PLAY, POOR, RAGE, ROCK, WHAM
SHAW: GRIM, JOHN, MIKE, NAME
SHED: BARN, BIKE, COAL, DARK, DROP, FLED, GATE, HOME, HUTS, LEAF, SKIN, TOOL, TRAM, VICE, WALL, WOOD, YARD
SHIN: BARK, BEEF, BONE, BUMP, CALF, FOOT, HACK, HURT, KICK, KNEE, LEGS, SHIT, SHOE, SOCK, SORE
SHIP: AHOY, BARK, BEAM, BILE, BOAT, BOOM, BOWS, BULK, CLIP, COIL, CREW, DECK, DOCK, FISH, FLAG, FLOG, FORE, GREY, HOLD, HOME, HULL, KNOT, LINE, LIST, LONG, MAST, MATE, MOON, NAVY, OILY, OOPS, PEER, PIER, PORT, PROW, RATS, ROCK, ROPE, SAGA, SAIL, SANK, SEAL, SEAS, SEND, SHOD, SHOP, SICK, SINK, SMOG, SOUL, SUNK, SWAY, TEAK, TIED, TIES, TIME, TOOT, TRIP, VAST, WAKE, WOOD, YARD
SHIT: ABEL, ANUS, ARSE, BILE, BRAN, BULL, CRAP, CUNT, DIRT, DOGS, DUNG, FART, FOUL, FUCK, HASH, HEAP, HOLE, IDEA, JOKE, LUMP, MESS, MIRE, MUCK, PIGS, PILE, PISH, PISS, POTS, RIDE, SELF, SHIN, SHIT, SHOD, SHUT, SICK, SPEW, SPIT, SSSH, THIS, WORD
SHOD: BARE, BOOT, CLAD, CLOD, COAT, FEET, FOOT, HOOF, PEAS, PONY, SHIP, SHIT, SHOE, SKIN, SLIP, THUD, WELL
SHOE: BOOT, EASE, FEET, FOOT, GLUM, HEAL, HEEL, HOLE, HOOF, HORN, KICK, LACE, LAST, PUMP, RACK, SHIN, SHOD, SHOP, SIZE, SLIP, SOCK, SOFT, SOLE, STUD, TACK, TALL, TOES, TREE, WEAR
SHOP: BILL, BOOK, BOOT, CAFE, CAKE, CARD, CHOP, COLE, FISH, FOOD, FULL, GIFT, GIRL, HATS, HERE, LIFT, LIST, MEAT, OPEN, POSH, REED, SALE, SELL, SHIP, SHOE, SLIP, SOLD, STOP, TALK, TILL, TOOL, TOWN, TOYS, WARE, WINE, WORK
SHOT: BALL, BANG, DARK, DEAD, DOWN, GOAL, GOOD, GUTS, HOOF, HURT, LEAD, LINE, MOON, PLAN, PUTT, SNAP
SHOW: BIRD, BOAT, CASE, CAST, CRIB, CROW, DOWN, DRAG, FAIR, FILM, GALA, GANG, GIVE, HIDE, JAZZ, JUMP, LIVE, LOOK, MEND, MUCH, NUDE, PLAY, POSE, QUIZ, SEEN, SIDE, SKIT, TIME, YELL
SHUT: BOOK, DOOR, DOWN, EYES, FOLD, GATE, HUTS, OPEN, SHIT, TRAP
SICK: BILE, BOAT, BOUT, BOWL, BURP, CURE, DEAD, DUTY, GULP, HEAL, HONK, ILLS, JOKE, JUDO, LACY, LARD, LIMP, MESS, MILK, NESS, OILY, PAIN, PALE, PILL, PITY, PUKE, SHIP, SHIT, SPEW, SWAY, WEAK, WELL
SIDE: BACK, BEEF, BEND, BENT, BIAS, CAMP, CUBE, DOCK, DOOR, DRUM, EDGE, FIRE, FLIP, GULF, HILL, KERB, KICK, LAKE, LEFT, LINE, MOSS, PEST, PORT, ROAD, RUMP, SEAT, SECT, SHOW, STEP, TEAM, VIEW, WALK, WAYS, WEST, WING
SIFT: SORT
SIGH: ALAS, DOWN, FADE, GASP, GRIN, GUST, HISS, HUFF, LONG, MOAN, NIGH, PANT, PHEW, SOFT, TEAR, WEEP, WIND, WISH, YAWN
SIGN: CALL, ESSO, FAIL, FLAG, FORM, HALT, HERE, MARK, NAME, NEON, PASS, PAST, POST, ROAD, SOLD, WHAT, WITH
SILK: FEAR, FINE, GOWN, HAIR, LACE, MILK, MOTH, PUKE, PURE, SARI, SASH, SILL, SOCK, SOFT, SPUN, WARM, WOOL, WORM
SILL: BILL, BIRD, CALM, DIKE, EDGE, HURT, KILL, LOOK, POND, SILK, TILL
SILO: BARN, CORN, COWS, FARM, HORN, KNOW, LILO, SALT, SOLO, TAPE, THIN, WELD, WHAT, WORD
SINE: CURE, FIBS, FINE, HALT, LACK, MINE, MORE, POST, RUDE, RULE, WAVE
SING: BAWL, CALL, CANT, DRUM, FLAT, FOLK, HYMN, LARK, LING, LOUD, MIKE, MIME, NOTE, POET, RING, SONG, SUNG, THEY, TONE, TUNE
SINK: BATH, BOAT, BOWL, COSH, DEEP, DIVE, DOWN, FALL, FULL, LEAK, LIST, MIRE, PANS, PLUG, POTS, RINK, RISE, ROPE, SANK, SCUM, SEEP, SHIP, SPEW, SWIM, TAPS, TILE, UNIT, WASH, WELL, WINK, WOOD, YELL
SINS: EVIL, FISH, HELL, LIFE, MANY, PAST, SOUL, THUG, WHAT
SIRE: DAMN
SITE: BOMB, CAMP, DUMP, EYES, KILL, KITE, LAND, MARK, PLAN, PLOT, RUIN, SIZE, VALE, VIEW, WORK
SITS: DESK, DOWN, EXAM, HITS, LIED, LIES, PITS, REST, SEAT, TITS
SIZE: ABLE, AREA, ATOM, BOOT, COAT, FITS, FOOT, FOUR, GROW, HEAD, HIPS, HOPE, HUGE, KING, LIFE, NINE, PINT, SHOE, SITE, SONG, TYPE
SKAT: SKIT
SKID: LIDS, OILY, SKIT, SLIP
SKIN: ACNE, ANON, BALD, BARE, BEAR, BITE, BODY, COOL, COON, CYST, DEEP, FACE, FAIR, FEAR, FEEL, FLAP, FORE, FROG, GOAT, GUTS, HAIR, HIDE, HOOF, HORN, ITCH, LARD, MOLE, NAIL, NECK, NEXT, NUDE, OILY, PEEL, PICK, PINK, RASH, SEAL, SHED, SHOD, SLIP, SOFT, SPOT, TEST, TORN, WOLF
SKIP: BOAT, COAL, FILL, GIRL, GLEE, HOOP, JUMP, LEAD, LINE, MISS, OMIT, PLAY, ROPE, SONG, SPIN
SKIT: BOAT, FOOL, GOON, JOBS, JOKE, JUMP, LANE, MOCK, PLAY, RUDE, SHOW, SKAT, SKID, SONG, TAKE
SKYE: ISLE
SLAB: BARE, BEAM, BODY, CAKE, CLAP, COAL, COLD, CRAB, FISH, FLAG, LUMP, PATH, ROCK, SAKE, SLOB, SOAP, WOOD
SLAG: DUMP, SWAG, TIPS
SLAM: WHAM
SLAP: LOUD, TRAP
SLAW: COLE
SLAY: BELL, CAIN, CHOP, DEAD, HILL, KILL, RIDE, STAY, THEM
SLEW: GREW
SLID: SLIP
SLIM: DIET, DISK, FITS, FOOD, GIRL, LEAN, LIMP, LINE, NEAT, POND, RAKE, SEXY, TALL, THIN, TREE, TRIM, TWIG
SLIP: BAND, COAT, DASH, DECK, DISC, DOWN, DROP, EASE, FALL, FELL, GIRL, KNOT, LACY, LEAK, LINO, OOPS, OVER, SHOD, SHOE, SHOP, SKID, SKIN, SLID, SNOW, TOGA, TRIM, TRIP
SLIT: GILL
SLOB: BLOB, BURK, DRIP, FOOL, HEEL, JOHN, KNOB, LAZY, LIPS, LOUT, MESS, PETE, PUNK, SELF, SLAB, SLUT, SNOB, SOFT, SPIT, THUG, TWIT
SLOE: CAST, DOWN, EYED, EYES, FAST, FISH, LEAF, ONLY, PISS, SLOW, SNOW, WHAT, WINE, WORM
SLOP: MELT
SLOT: COIN
SLOW: BACH, BOAT, DARK, DOWN, DULL, FART, FAST, FLOW, GLOW, GROW, HAIL, HASH, IDLE, LACK, LAZY, LOTH, PACE, RAIL, RATE, SLOE, SLOW, STOP, TIME, VERY, WALK, WORK, WORM
SLUG: BAIT, DEAD, GRUB, GUST, LEAF, SALT, THUG, TOAD, WHAT, WORM
SLUM: SCUM
SLUR: DRAG, MARK
SLUT: SLOB, SMUT, TART
SMOG: CITY, DARK, DIRT, FOUL, HAZE, HERE, MASK, MIST, POOL, REES, SHIP, SMUT, SNOG, SNUG
SMUG: COZY, GRIN, THUG
SMUT: BLOB, BOOK, BOOT, COAL, DIRT, DUST, GERM, JOKE, MUCK, NOSE, SLUT, SMOG, SMUT, SOOT
SNAG: CRAG
SNAP: BANG, BEND, BITE, CARD, CRAP, GAME, GIRN, GREY, JERK, POOL, POPS, SHOT, SNIP, TWIG
SNIP: CLIP, SNAP, SNIP, WIRE
SNOB: FOOL, FOWL, GIRL, GOSH, HUFF, NECK, NOSE, ONES, POSH, PRIG, PUFF, SLOB, SNOB, SNOT, SNUB, TOFF, TORY, TURD, YETI
SNOG: BOMB, CLOG, COSY, DARK, GIRL, KISS, LAMP, LIPS, NECK, NICE, PASS, SMOG, SOFA, WARY
SNOT: SNOB
SNOW: BALL, BERG, BOOT, BUNT, COAT, COLD, DOWN, DROP, FALL, FAST, GLEN, GLOW, HAIL, JOHN, KANE, KING, MELT, PURE, RAIN, SAND, SLIP, SLOE, TOPS, WIND
SNUB: DOOR, FLAT, FOOT, HARD, HATE, HURT, LEER, MISS, NOSE, OMIT, PASS, RUDE, SNOB
SNUG: COSY, COZY, KISS, OVER, SMOG, WARM
SOAK: BATH, BOAT, POUR, RAIN, SEEP, SOAP, SUDS, SWIM, WASH
SOAP: AIRY, AVON, BATH, BLUE, CAKE, DIRT, DISH, FACE, FOAM, GIRL, JOKE, LOPE, PEAR, SCUM, SLAB, SOAK, SOFT, SUDS, THAT, TIDE, WASH
SOAR: BIRD, BLUE, DROP, FALL, FOUR, FREE, GULL, HIGH, HURT, KITE, LARK, OUCH, RISE, SEER, ZOOM
SOCK: BOOT, DARN, FEET, FOOT, HEEL, HOLE, JAMB, MEND, MOCK, SACK, SHIN, SHOE, SILK, WASH, WHAM, WOOL
SODA: AUNT, BALL, BEER, FIZZ, GRIP, LIME, MINT
SODS: ODDS
SOFA: COZY, FIRE, HAIR, KISS, NAME, NEAR, NECK, ROOM, SEAT, SNOG, SOFT
SOFT: ARTS, BABE, BEDS, CALM, CLAY, DAFT, DOWN, EASY, FACE, FEEL, FELT, FIRM, FOOT, FORM, HAIR, HARD, HURT, IRIS, KIND, LAZY, LEGS, LINE, LIPS, LOUD, LOVE, MEEK, MELT, MILD, MINK, MOSS, MOTH, NICE, OPEN, PEAR, PUSS, RIPE, SHOE, SIGH, SILK, SKIN, SLOB, SOAP, SOFA, SOOT, SURE, TANG, THIN, TUNE, WARE, WARM, WIND, WING, WOOL
SOHO: BLUE, KILT, VICE
SOIL: BOAT, BOIL, CLAY, DIRT, FOOD, FORK, GROW, HEAP, LIMY, LUMP, MUCK, RAKE, RAPE, ROOT, SEED, SERF, TILL, TOIL, TREE, TYPE, WORM
SOLD: BOLD, COLD, FLOG, GOAL, GONE, HIRE, KEPT, LOST, SALE, SEAL, SELL, SHOP, SIGN, SONG
SOLE: BOOT, FEET, FISH, FOOT, FULL, GRIP, HEEL, LIFE, LONE, ONLY, SALE, SHOE
SOLO: DRUM, SILO
SOME: BODY, COME, DAMN, FOOL, FOUR, FULL, GLEE, HALF, HAND, HILL, HOPE, LONE, LOTH, LOTS, MANY, MORE, MOST, NONE, ONES, ONLY, PART, SEND, SUCH, TIME, WANT
SONG: BAND, BEAT, BEER, BIRD, BOAT, BREW, CANT, FOAM, FOLK, GANG, GLAD, GONG, GOOD, HART, HYMN, LONG, MIKE, NOTE, OTIS, POEM, POET, POPS, RING, SASH, SEEK, SING, SIZE, SKIP, SKIT, SOLD, STER, SWAN, TIME, TONE, TRIO, TUNE, WINE, WONG, YEAH
SONS: BOYS, HAIR, MALE
SOOK: SUCK
SOON: ANON, BACK, BOON, COME, EXAM, FUCK, GOOD, LAST, LATE, MEET, NEAR, NEXT, NIGH, NOON, OVER, THEN, VERY, WAIT, WALK, WHEN
SOOT: BAGS, CHAR, COAL, DIRT, DUST, FINE, FIRE, FLUE, MOOT, SMUT, SOFT, SOOT
SORE: ACHE, ARSE, BACK, BOIL, BURN, CHAP, COLD, CYST, EYES, FEEL, FEET, FELT, FOOT, GASH, HACK, HAND, HATE, HEAD, HEAL, HEAT, HURT, ITCH, KICK, LIMP, LUMP, MORE, NECK, OUCH, PAIN, PILE, POUR, PUSS, RASH, RASP, SCAB, SCAR, SHIN, SPOT
SORT: CASH, GAME, KIND, MAIL, MEND, SIFT, TAPE, TIME, TYPE, TYRE, WHAT
SOUL: BODY, DISC, HART, HEAL, IRON, KIND, LIFE, LOST, MALE, NONE, OTIS, POOR, PURE, SAKE, SAVE, SHIP, SINS, TWIN
SOUP: BEAN, BOWL, BRIM, CHEF, COLD, DISH, DUCK, FOOD, GOOD, HARE, LAMB, LEEK, MEAL, MILK, PEAS, SCUM, SUDS, SWAN, WARM
SOUR: ACID, BEEF, GRIM, LIME, MILK, MOOD, NICE, PAIN, PORK, PUSS, RIPE, ROCK, SALT, TANG, TART, WINE
SOWN: SEED
SOWS: COWS
SPAM: BEEF, WHAM
SPAN: ARCH, AREA, HAND, LIFE, SCAN, TIME, TREE, WIDE, WING
SPAT: SPIT
SPEW: BEER, BOAK, BOKE, GUSH, GUTS, HONK, LIPS, PISS, PUKE, SHIT, SICK, SINK, SPIT, STEW
SPIN: AXIS, BOWL, COIN, DARN, DISC, DOWN, FLAT, FLIP, HALF, HOOP, IZZY, LOOM, REEL, RIDE, SKIP, SPUN, TOPS, TRIP, TURN, WOOL, YARN
SPIT: BEER, BILE, BOWL, CHEW, EARN, FINE, FIRE, FOUL, HACK, HAWK, HISS, LICK, MISS, PIPS, PREY, SHIT, SLOB, SPAT, SPEW, SPOT, VILE
SPOT: ACNE, BALL, BLOB, BOIL, CLUE, CYST, DICE, DIRT, DROP, DUST, FACE, JUDY, MARK, MOLE, NOSE, PUKE, RASH, SKIN, SORE, SPIT, THIS, WELD
SPUD: ARMY, BOAT, HOLE, MASH, MATE, PEEL
SPUN: GOLD, HOME, KILT, LOOP, REEL, SILK, SPIN, TALE, WOOL, YARN
SPUR: URGE
SSSH: FIZZ, HAND, PSST, REST, SHIT, WAVE, WIND
STAB: BACK, BATS, COSH, CRAB, HILL, HURT, KILL, PAIN, PANG, POKE
STAG: DEER, GLEN, HUNT, MOOT
STAN: LEES
STAR: DOME, DUST, FAME, FILM, FIVE, FOUR, GAME, GAZE, IDOL, LESS, LONE, MOON, NOVA, POLE, POPS, TREK, TURN, WALL, WAND, WISH
STAY: AWAY, BORE, DOWN, FLEE, GRAY, GROW, HERE, HOME, KEPT, LIVE, LONG, MAIN, MOVE, REST, SANE, SLAY, STOP, WAIT, WIRE, WITH, YARN
STEM: APEX, BOWS, FLOW, GLUE, LEAF, PIPE, PROW, ROOT, ROSE, SUCK, THIN, TIDE, TREE
STEP: BOOT, DOOR, DOWN, FEET, FOOT, GREY, HIGH, MIND, OVER, PACE, RUNG, SIDE, THIS, TOOK, TRIP, WALK, WORD
STER: SONG
STEW: BALL, BEEF, BEER, BOIL, BREW, COOK, FOOD, HASH, LEAK, LEEK, MEAT, PLUM, SPEW, VEAL
STIR: WHIP
STOP: APEX, COMA, COUP, DEAD, DENY, DOOR, DROP, EASE, FAIL, FLOW, GREW, HALT, JOLT, KERB, KNOW, LIFT, LOOK, MILE, MOVE, PACE, PAGE, PAIN, PARK, PASS, PAWS, PILL, PLUG, POTS, REST, ROAD, RUSH, SHOP, SLOW, STAY, STOP, SUIT, TEST, THIS, WAGE, WAIT, WALK, WALL
STUB: AXLE, BANG, BUTT, FOOT, NAIL, NOSE, TAIL, WHAT
STUD: BELT, BOLT, BOOT, BULL, CLIP, CUFF, FARM, GOLD, MARE, PLAN, SHOE
STUN: DRUG
STYE: PIGS
SUCH: BLOW, CASE, FACT, FOOL, GOOD, LIES, LIFE, LIKE, LONG, LORD, LUCK, MESS, MUCH, NONE, OWEN, SOME, SUCH, SUCK, THAT, THUS, VAIN, WHAT, WORD
SUCK: BABY, BLOW, CHEW, COCK, DRAW, DUCK, EGGS, FLOW, FUCK, GUMS, HEMP, KISS, LICK, LUCK, MEAT, MILK, MINT, ROCK, SOOK, STEM, SUCH, TITS
SUDS: BATH, FOAM, MUFF, SOAK, SOAP, SOUP, WASH
SUED: SUES
SUES: BLUE, CUNT, FINE, GIRL, SUED, TOES, WIFE, WRIT
SUET: BEEF, CHOP, DUET, DUFF, FOOD, FOUL, ROLL, SUIT
SUEY: CHOP
SUEZ: GULF
SUIT: ABLE, BEST, BLUE, BOYS, CARD, CASE, COAT, DARK, FITS, GENT, GREY, HIRE, ITCH, LOST, POSH, STOP, SUET, SWIM, UGLY
SULK: HUFF
SUMP: OILY
SUMS: ADDS, COST, GAME, GLUE, HELL, PLUS, TEST, WORK
SUNG: NOTE, SAFE, SING
SUNK: SANK, SHIP, TIRE
SURE: BLUE, COLD, DEAD, EVER, FAST, FIRE, FIRM, GOAT, KNOW, NEAT, PURE, REAL, SAFE, SAVE, SOFT, TRUE, WAVE, WELL, YEAH
SURF: FOAM, SCUM, SEAS, TIDE
SWAG: ADAM, BANK, BEER, BOOT, BORE, BRAG, DRAG, HAUL, LOOT, MASS, SLAG, SWAY
SWAM: SANK, SWIM
SWAN: ALAN, AVON, BIRD, DEER, DOWN, DUCK, GASP, LAKE, MOOT, NECK, OILY, POND, SONG, SOUP, UGLY, WILD
SWAY: AWAY, BEND, BLOW, BOAT, CORN, FALL, FLAG, LEAN, LILT, MOVE, PULL, ROCK, SHIP, SICK, SWAG, TILT, TREE, TURN, WAVE, WIND
SWIM: AFAR, ARMS, AWAY, BATH, BOAT, COOL, DAZE, DIVE, DUCK, FAST, FISH, GALA, JUNE, LAKE, NEWT, PIGS, POOL, SANK, SEAS, SINK, SOAK, SUIT, SWAM, TOGS
SWOT: EXAM, KEEN
TACK: BOAT, FOOT, HACK, NAIL, READ, ROCK, SAIL, SHOE, TACK, TAIL, TICK
TAGE: ARMY
TAGS: RAGS, TOGS
TAIL: APEX, ARSE, BEAK, BIRD, BODY, BULL, BUSH, COAT, COON, DOVE, FLAP, GAOL, HAIR, HEAD, HORN, LONG, MANE, MICK, NOSE, PAWS, PONY, PULL, STUB, TACK, TEST, THIN, TREE, WING
TAKE: ALAN, AWAY, BITE, BOOK, CARE, COUP, DOWN, DRUG, FAKE, FIVE, FOUR, FROM, GARB, GAVE, GIVE, GRAB, GRIP, HOLD, HOME, JOIN, LEND, LIFT, MAKE, MICK, MINE, MISS, MUST, NICK, OATH, OVER, PART, PECK, PICK, PILL, PULL, RISK, SEND, SKIT, TASK, THAT, THIS, TILL, TIME, TOOK, TRIP, USED, WAKE, WILL, YOUR
TALC: BOND, TANG
TALE: CITY, FOOT, GRIM, HEAD, LAIR, LIES, MYTH, SAGA, SAIL, SPUN, TALL, TELL, TOLD, VEIN, WAIT, WOLF, YARN
TALK: BACK, BRUM, CANT, CHAT, DOLL, DOWN, DUMB, EASY, FAST, IDLE, LOUD, MUCH, ORAL, PRAY, READ, RULE, SAID, SHOP, TALK, TELL, THAN, THIS, TONG, TOWN, WALK, YARN
TALL: ARCH, CHAT, COAT, COLD, CRAG, DARK, GIRL, GREW, GROW, HIGH, IDOL, JUMP, LEAN, LOFT, LONG, MAST, PINE, POLE, SHOE, SLIM, TALE, THIN, TREE, WALK
TAME: BEAR, BIRD, DEAD, DOGS, LAME, LION, MILD, MONK, TIRE, WILD
TANG: BEER, BITE, BODY, LANG, LICK, MIST, RANG, SALT, SOFT, SOUR, TALC, TANG, TING, VASE, ZING
TANK: AMOK, ANTI, ARMY, BANG, BEAT, BEER, DANK, FISH, FUEL, GUNS, LEAK, NEWT, RANK, YANK
TAPE: BIND, DECK, DISK, EDIT, INCH, LEAD, MARK, MASK, MODE, RACE, RAPE, SELL, SILO, SORT, WIRE, WORM
TAPS: BARS, BATH, BEER, COLD, CUTS, DIES, DRIP, FLAG, FROM, HITS, MINE, SINK, TIES, TIPS, TURN, WASH
TARN: LOCH, MOOT
TART: ACID, BAKE, BIRD, CAKE, CART, CURD, DISH, EYES, FART, FOOD, GIRL, JAMB, LEGS, NICE, PLUM, SLUT, SOUR
TASK: ANUS, COAL, DARE, DEED, DUTY, EASY, GRIM, HARD, MASK, RISK, TAKE, WORD, WORK
TATE: ROTE
TAUT: WIRE
TAXI: CABS, COST, FARE, FOOD, HIRE, HOME, HONK, HORN, LATE, RAIN, RANK, RIDE, ROAD, TIPS, TOWN
TEAK: DUCK, HARD, LEAK, MILK, SHIP, WEAK, WOOD
TEAM: BALL, BEAM, BOAT, CITY, CLUB, GAME, GOAL, GOLF, JOIN, MATE, PLAY, QUIZ, RACE, SIDE, WORK
TEAR: AWAY, DOWN, DROP, EYES, FOLD, FRAY, FULL, GASH, GORE, HATE, HOLE, JERK, MEND, MOOD, OPEN, PART, PEAR, PITY, PULL, RENT, SIGH, TIME, TORE, TORN, WARE, WEAR, WEEP, WEPT, WIPE
TEAS: CAFE, CAKE, CUPS, DALE, EATS, FOOD, GOLF, HIGH, HOME, MADE, TIME, WARM
TEEN: AGED, AGER, BEAT, FOUR, FUCK, NINE
TELL: AVIV, BELL, CANT, DENY, FELL, FORE, KNOW, LEVI, LIES, SAGA, TALE, TALK, TOLD, UPON, WELL, WHAT, WORD, WORK
TEND: CARE, FARM, FEND, HEAL, HELP, LEAN, LEND, LOOK, LOVE, MEND
TENS: UNIT
TENT: ARAB, BENT, BILL, BLOW, CAMP, COLD, DAMP, FEND, FETE, FIRE, FLAP, HIDE, HILL, LAWN, PEGS, POLE, RAIN, RENT, ROBE, ROPE, SAND, TORE, WINE
TERM: LENT
TEST: ABLE, ACID, CAMP, CASE, CUBE, CURE, EXAM, FAIL, FEAR, FILM, HARD, ICLE, MADE, MARK, MEAN, ORAL, PASS, QUIZ, SKIN, STOP, SUMS, TAIL, TEST, THIS, THUS, TIME, TREE, TUBE, WORD
TEXT: BOOK, BOOT, GIST, NEXT, PAGE, READ, WORD, WORK
THAN: ALSO, EVEN, EVER, HAVE, HOLY, LESS, LOVE, MINE, MORE, TALK, THAN, THAT, THEN, THIS, WHAT, WHEN
THAT: CHAP, DARN, FACT, HEAR, HECK, KNOW, LEST, LIFE, SAID, SOAP, SUCH, TAKE, THAN, THAT, THIS, THUS, TIME, WHAT, WISH, WORD
THAW: LESS, MELT
THEE: FARE, ONLY, SEEK, THOU, UNTO, WHAT, YOUR
THEM: ALSO, BOTH, DISH, DROP, FUSS, GAIN, HANG, HOLD, KIDS, KNEW, KNOW, LIKE, MANY, MEET, NAME, NEWS, RAID, SEEM, SLAY, THEY, TIME, UNTO, WHOM
THEN: ALSO, AWAY, DONE, EVEN, FROM, GONE, HELP, KNEW, NEXT, ONCE, SOON, THAN, THEY, THIS, THUS, TILL, TIME, WERE, WHAT, WHEN, WILL
THEY: CAME, SING, THEM, THEN, THIS, WANT, WERE, WHEN, WILL, WORD
THIN: AIRY, BOOK, DIET, EDGE, FILM, FINE, FLAT, FOIL, FOOD, IDLE, LEAN, LEGS, LINE, LONG, NAIL, NECK, PALE, PIPE, RAKE, RIBS, SILO, SLIM, SOFT, STEM, TAIL, TALL, TRIM, TWIG, WEAK, WEED, WIRE, WORM
THIS: BIRD, BORE, CRAP, CUNT, DULL, FEEL, HAZE, HEAR, HERS, KNOW, LIFE, LIKE, LIST, NAME, NEXT, NICK, PINT, POLL, PULL, QUIZ, READ, SAID, SEEN, SELF, SHIT, SPOT, STEP, STOP, TAKE, TALK, TEST, THAN, THAT, THEN, THEY, THIS, THUS, TIME, WEEK, YAWN, YEAR
THOU: HAIL, HOLY, SAND, THEE, THUS, TWIT, UNTO, WILT, YOUR
THUD: BANG, BUMP, DULL, JOLT, SHOD
THUG: BEER, BOAT, COSH, FILM, GANG, KILL, LOUT, NAZI, NICE, SINS, SLOB, SLUG, SMUG, TOAD
THUS: ERGO, EVER, FUSS, LIKE, SUCH, TEST, THAT, THEN, THIS, THOU, THUS, UNTO, WHAT
TICK: BUYS, FLEA, FLEE, GNAT, HICK, HOUR, LICE, LICK, LIPS, MARK, PLAN, ROCK, TACK, TOCK
TIDE: FINE, FLOE, FLOW, FOAM, HIGH, LINE, MARK, MOON, NOON, ROCK, SEAS, SOAP, STEM, SURF, TIME, TURN, WAKE, WASH, WAVE
TIDY: BILL, DESK, FILE, HAIR, HALT, KEEP, MESS, MIND, NEAT, ROOM, TRIM
TIED: BOND, DOWN, ENDS, FREE, HELD, KNOT, LACE, ROPE, SHIP
TIES: DOWN, GOWN, HOME, KNOT, LOSE, NECK, SHIP, TAPS, WITH
TILE: BATH, BOOK, EARL, FILE, FLAT, KING, LING, LINO, LIST, LORD, ROOF, ROOT, SINK, TIRE, WALL
TILL: BELL, CASH, DING, EVER, LAND, LATE, LEST, NEXT, SHOP, SILL, SOIL, TAKE, THEN, UNTO, WAIT, WHEN
TILT: BACK, BEND, BIAS, CANT, COUP, JOLT, KILT, LEAN, LIFT, LIST, MOVE, NOSE, OVER, ROCK, ROLL, ROOF, SWAY, TURN, WAVE, WILT
TIME: AGES, BALL, BAND, BATH, BEAT, BEST, BOMB, BUSY, DATE, DIME, DRAG, EACH, EVEN, EXAM, FILL, FIND, FINE, FOOD, FREE, FROM, FULL, GAIN, GLAD, GOOD, HALF, HAVE, HOME, HOUR, JEST, JUST, LACK, LAST, LATE, LEAN, LESS, LIFE, LONG, LOSE, MAIL, MAKE, MARK, MEAL, MEAN, MEAT, MEET, MEND, MORE, MUCH, NEWS, NEXT, NICK, NIGH, NINE, NOON, ONCE, OVER, PACE, PART, PASS, PAST, PEAK, PIPS, PLAY, QUIZ, RACE, RATE, REST, RIPE, RISE, ROCK, SAKE, SAME, SAND, SAVE, SEED, SHIP, SHOW, SLOW, SOME, SONG, SORT, SPAN, TAKE, TEAR, TEAS, TEST, THAT, THEM, THEN, THIS, TIDE, TOOK, TRIP, UNIT, UPON, WAIT, WEEK, WHAT, WHEN, YEAR, YOUR
TING: BELL, GULL, KNIT, LING, PING, RING, TANG, TING, TONG, VASE, WONG, ZING
TINS: CANS, LIDS, MESS
TINY: ATOM, BABY, FEET, TOTS
TIPS: BETS, CART, COAL, DUMP, ENDS, FAGS, HINT, HIPS, LIPS, PALM, PENS, SLAG, TAPS, TAXI, TOES, TOPS
TIRE: ACHE, AUTO, BASS, BEAT, BORE, DEAD, EASY, FIRE, FLAG, HELL, HIRE, JACK, LIFE, NOUN, REST, ROAD, SUNK, TAME, TILE, TUBE, TYRE, WEAR, WORK, YAWN
TITS: BARE, BIRD, BITS, BLUE, BODY, BRAS, BUST, FIRM, NUDE, PAIR, POPS, SITS, SUCK, TITS, TOPS, TORN, WITS, WOOD
TOAD: COLD, FROG, HALL, HOLE, MOLE, NEWT, SLUG, THUG, TOOL, TOOT, UGLY
TOCK: TICK
TOES: COMA, FEET, FIRE, FIVE, FOOT, HAND, HEAD, HEEL, LEGS, LONG, ONES, PAIN, SHOE, SUES, TIPS, TOPS
TOFF: GENT, POSH, SNOB
TOGA: BATH, HOME, JUDO, ORGY, ROBE, ROME, SARI, SLIP, TOGS, WHIP, YOGA
TOGS: FEET, FOGS, FOOT, GARB, KEYS, RAGS, RAIN, ROPE, SWIM, TAGS, TOGA, TOGS, WEAR, WHAT, WOGS, WOOD
TOIL: BOWL, DAYS, FOIL, FUME, GARB, HARD, HART, PAIN, REST, SOIL, WORK
TOLD: BELL, GOLD, SAID, TALE, TELL, WHAT
TOLL: BELL, FARE, LEVI, ROAD
TOMB: BOMB, CALM, DEAD, DOWN, GONE, HALL, WALL, WOMB
TOME: SEED
TONE: BASS, BELL, BONE, DEAF, HEAR, HIGH, MOOD, NOTE, PETE, SEMI, SING, SONG
TONG: BELT, COAL, FIRE, FORK, GANG, GONE, GONG, IRON, KING, KONG, LING, MING, PING, TALK, TING, TONG, TOOL, WHAT, WONG
TONK: HONK
TONY: HART, LOCK, MOCK, ROAM
TOOK: AWAY, BOOK, FOOD, FROM, GAVE, GRAB, HEAD, HOLD, HOME, LEFT, LIFE, LOOK, LOVE, NAME, NOOK, OVER, PART, STEP, TAKE, TIME, WHAT, WIFE
TOOL: CASE, COIN, COOL, FILE, FOOL, HAND, HARD, HELP, PIPE, RAKE, SHED, SHOP, TOAD, TONG, WORK
TOOT: BIRD, BLOW, BLUE, HONK, HOOT, HORN, LOOT, MOOT, ROOT, SHIP, TOAD, TOOT
TOPS: BEST, BOTS, CAPS, FOUR, HATS, HILL, HOPS, LIDS, POPS, ROOF, SNOW, SPIN, TIPS, TITS, TOES, TREE
TORE: BULL, COAT, DOWN, FRED, GORE, HILL, MORE, QUAY, REND, RIPS, RISE, ROCK, TEAR, TENT, TORE, TORN
TORN: BORN, FRAY, HOLE, MEND, MESH, RAGS, REND, RENT, SKIN, TEAR, TITS, TORE
TORY: BLUE, CRAP, LOFT, NICE, PEER, POLL, SNOB, WHIG
TOSS: BOSS, COIN, DICE, FLIP, PUSH
TOTE: FORM, PLAN, ROTE
TOTS: TINY, WITS
TOUR: ELSE, TRIP, YANK
TOWN: AREA, BATH, BERG, BIKE, BOOM, CAPE, CITY, DIRT, DOWN, FAIR, GOWN, GRIM, HALL, HICK, HOME, INTO, KIRK, LIFE, MIKE, MOOR, PLAN, ROME, SHOP, TALK, TAXI, TWIN, WARE, WICK, YORK
TOYS: BABY, BOYS, CARS, DOLL, GAME, GUNS, KIDS, PETS, PLAY, SHOP, WOOD, XMAS
TRAM: SHED
TRAP: BAIT, CAGE, CRAP, DOOR, DUST, FOOT, GATE, HARE, HOLD, HUNT, HURT, IRON, LAIR, MAZE, MICE, MOTH, PLOT, PONY, RARE, RATS, SHUT, SLAP, TRIP, WOOD
TRAY: BLUE, CUPS, DISH, EGGS, FEED, FLAT, FOOD, FULL, MILK, PATH
TREE: BANK, BARE, BARK, BEAN, BIRD, BOOK, BUDS, BUSH, CLIP, CONE, CRAB, CRAG, DOVE, ELMS, FELL, FIGS, FIRS, GREW, GROW, HACK, HILL, HIVE, IRIS, LAKE, LANE, LAWN, LEAF, LIFE, LIMB, LIME, LINE, LOCH, LONG, MAID, MONK, MOSS, NEST, NUTS, PALM, PARK, PEAR, PECK, PINE, PLOT, PLUM, PULP, ROOT, ROSE, SHOE, SLIM, SOIL, SPAN, STEM, SWAY, TAIL, TALL, TEST, TOPS, TWIG, VINE, WALL, WIND, WOOD
TREK: BIKE, BOER, CART, HIKE, HOME, LONG, LOST, POLE, PONY, STAR, WALK
TRIM: BOAT, BODY, BRIM, EDGE, HAIR, LEAN, MISS, NEAT, NEST, SAIL, SLIM, SLIP, THIN, TIDY
TRIO: BAND, BELL, BERT, CHOW, DUET, JAZZ, PAIR, SONG
TRIP: ACID, BOAT, DRUG, FALL, HAVE, HOME, LOAD, LONG, OVER, SHIP, SLIP, SPIN, STEP, TAKE, TIME, TOUR, TRAP
TROT: CLOP, GAME, HOOF, PIGS, PONY, RACE
TRUE: BLUE, FACT, FORM, FUND, GOOD, HATE, HEAP, JEST, JUST, LACY, LAIR, LIAR, LIER, LIFE, LOVE, MYTH, OWED, REAL, RING, SURE, VERY, VOID, WARM, WISH
TUBA: BAND, BASS, BLOW, BULB, DEEP, FISH, HORN, LAND, LOUD, OBOE, PLAY, ROOF, ROOT, RUDE, TUBE, WIND
TUBE: BANK, BATH, BEND, BORE, CASK, CUBE, FEET, FLOW, GLUE, LONG, LUNG, MISS, PIPE, POLE, RUSH, TEST, TIRE, TUBA, WAIT
TUNE: BEAT, FULL, HYMN, JUNE, LING, LOOT, NICE, NOTE, PIPE, PLAY, SING, SOFT, SONG
TURD: SNOB
TURF: MOSS
TURK: MOOR
TURN: AWAY, BACK, BEND, DISC, DONE, FACE, FAST, FELT, FLIP, FOLD, FORK, FUCK, KEYS, KNOB, LEAF, LEFT, MORE, MOVE, NEXT, OVER, PAGE, REEL, ROAD, ROLL, ROTE, SPIN, STAR, SWAY, TAPS, TIDE, TILT, TURN, VICE, WHOM, WIND, WORM, YOUR
TUSK: FANG
TWAT: DOZY, TWIT
TWIG: BARK, BENT, LEAF, NEST, SLIM, SNAP, THIN, TREE, WOOD
TWIN: BABY, BEDS, GIRL, KATY, LINE, PAIR, SAME, SETS, SOUL, TOWN, TWIT
TWIT: BIRD, BLUE, BRAT, BURK, CLOT, DAFT, FACE, FLIT, FOOL, FRET, HEAD, JERK, OGLE, POPE, SLOB, THOU, TWAT, TWIN, TWOO, VERB
TWOO: TWIT
TWOS: ONES
TYPE: ARCH, BELL, BOLD, CAST, COIN, COPY, FACE, FIRM, GIRL, KIND, LINK, LINO, MODE, SIZE, SOIL, SORT
TYRE: AVON, BIKE, BLOW, FEND, FIRM, FLAT, JACK, PEEL, PUMP, RAFT, SORT, TIRE, WALL
UGLY: DUCK, FACE, FAIR, FEAR, FOOT, FOWL, GIRL, HOAR, KIND, LEER, LIAR, LOTH, NEAT, NICE, NOSE, PLUG, SCAR, SUIT, SWAN, TOAD, VASE, WILD
UNIT: AREA, ARMY, BASE, CARE, CELL, CRAM, FILM, FIVE, FOOT, FOUR, GRAM, MAKE, PARK, SINK, TENS, TIME, WORK
UNTO: AWAY, CARS, COME, EVER, GIVE, INTO, SEND, THEE, THEM, THOU, THUS, TILL, UNTO, WARD, WHAT, WHOM, WITH
UPON: AVON, BACK, DEAD, FRAY, GAZE, HILL, HIRE, INTO, JUMP, MIND, NIGH, ONCE, OVER, RAIN, RODE, TELL, TIME, WHAT, WHOM
URGE: BERG, GAIN, HARD, HELP, LOVE, MAKE, MUST, NEED, PUSH, SPUR, WANT, WISH
USED: CARS, DONE, FELT, GONE, HACK, ONCE, TAKE, WORD, WORN
VAIN: CANE, FACE, GIRL, HOPE, JANE, MAIN, PAIN, POOF, SEED, SUCH, VAIN, VEIN, WIND
VALE: DALE, DAWN, DEEP, DELL, EBBW, EDAM, EDEN, EVIL, GLEN, HALL, HILL, LUNE, MEAT, PARK, PORT, SITE, WALK
VANE: WANE, WIND
VANS: CARS
VARY: FLUX
VASE: BOWL, MING, TANG, TING, UGLY
VAST: HALL, HOLE, HUGE, SHIP, WIDE
VEAL: CALF, DEER, FOAL, LAMB, LEAN, MEAT, PALE, PINK, PORK, STEW, VEAL
VEIL: LACY, MASK, MONK, SARI
VEIN: TALE, VAIN
VERB: LOVE, NOUN, TWIT, WORD
VERY: ABLE, BEST, COLD, COZY, EVER, FAST, GOOD, HARD, KEEN, MOST, MUCH, NICE, POSH, SLOW, SOON, TRUE, VERY, WEAK, WELL
VEST: BLUE, COAT, GARB, HAIR, HEAT, MAIL, WOOL
VICE: DICE, EVIL, GAME, GRIP, HATE, HOLD, LICE, LIKE, MICE, NICE, RICE, RING, SHED, SOHO, TURN, VICE, WOOD
VIEW: CARD, GAZE, HILL, HOPE, LAKE, LOOK, NICE, PARK, PLAN, REAR, ROOM, SELL, SIDE, SITE, WIDE
VILE: BASE, BILE, FOUL, SPIT
VINE: OATH, ROSE, TREE, WINE, YARD
VISA: PASS
VIVA: EXAM
VOID: CASH, DARK, FALL, GREY, GULF, NULL, TRUE
VOLT: JOLT
VOTE: POLL, ROTE
VOUS: CHEZ, POUR
WAGE: EARN, FEAR, LOSE, MORE, PAID, RATE, RISE, STOP, WORK
WAIL: BABY, BAWL, FEAR, HAIL, HOWL, MOAN, ROAR, WALL, WEEP
WAIN: CORD, WILT
WAIT: CANT, HALT, HANG, HATE, HERE, HOLD, HOUR, IDLE, LATE, LOCK, LONG, NOTE, SOON, STAY, STOP, TALE, TILL, TIME, TUBE, WAIT, WALK
WAKE: BELL, BOAT, RISE, SHIP, TAKE, TIDE, WAVE, WIDE
WALK: AWAY, BACK, CAKE, CANE, COLD, CRAB, DALE, DOWN, FALL, FAST, FEET, FELL, FOOT, GATE, HIKE, HILL, HOOF, LANE, LEAD, LEGS, LONG, LOPE, MAIL, MALT, MILE, MOVE, OVER, PACE, PACK, PAIN, PARK, PATH, PIER, RIDE, ROAD, ROAM, ROOT, ROPE, SIDE, SLOW, SOON, STEP, STOP, TALK, TALL, TREK, VALE, WAIT, WALK
WALL: BACK, CELL, CORN, CROW, DAMP, DIKE, ETON, FLAT, FLEA, GAME, GATE, GREY, HALL, HIDE, HIGH, HOLE, JAIL, LEAP, MOPS, NAIL, OVER, PEGS, QUIZ, ROOF, ROOM, SHED, STAR, STOP, TILE, TOMB, TREE, TYRE, WAIL, YARD
WAND: CANE, HAND, STAR, WAVE
WANE: FADE, FALL, FUCK, JOHN, KIDS, MOON, NAME, PAIN, PALE, POKE, RISE, VANE, WEAK
WANK: BANK, WINK, YANK
WANT: CARE, HAVE, HOPE, KNOT, LACK, LIKE, LOTH, LOVE, LUST, MORE, NEED, SOME, THEY, URGE, WEED, WHAT, WILL, WISH
WARD: BEDS, FEND, FORE, KING, MISS, ROBE, ROOM, UNTO, WEST, WING
WARE: BALE, BOWL, DISH, FAIR, FARE, FOOD, HARD, HARE, IRON, ITEM, POTS, SELL, SHOP, SOFT, TEAR, TOWN, WOLF
WARG: BERG
WARM: ANUS, BAIT, BODY, CALF, COAT, COLD, COOL, COSY, COZY, CUNT, DANK, DARK, FEET, FIRE, FUEL, GLOW, HEAT, HOME, JUNE, LIPS, LOVE, MILD, MILK, NEST, NICE, OVEN, PETS, PINK, SAND, SILK, SNUG, SOFT, SOUP, TEAS, TRUE, WOMB, WOOD, WOOL, WRAP
WARS: EVIL, FEAR, GREY, GUNS, HATE, HELL, KILL, MARS
WART: BOIL, CYST
WARY: CARE, DARK, EASY, EDGY, EVIL, GANG, HARM, MARY, RICH, SNOG, WIRE, WISE
WASH: BATH, COOK, DIRT, DISH, DOWN, EARS, FACE, IRON, NAIL, NECK, SINK, SOAK, SOAP, SOCK, SUDS, TAPS, TIDE, WIPE, WISH
WASP: FEAR, FLEE, GASP, GNAT, NEST, PAIN, RASP
WAVE: BAND, BLOW, BOAT, CURL, DEMI, ELMS, FLAG, FLAP, FLOE, FOAM, HAIR, HAND, HEAT, IDEA, MEAT, SERF, SINE, SSSH, SURE, SWAY, TIDE, TILT, WAKE, WAND, WIND
WAVY: HAIR, HAND, LINE, NAVY, PERM, SEAS
WAYS: EDGE, FIVE, GATE, MEAN, MEND, PART, PATH, RAIL, SIDE
WEAK: AGED, BEER, BOLD, DAMN, ILLS, LEGS, LIMP, LONG, LOUD, MEAK, MEEK, MIND, PALE, POOR, PUNY, RICH, SICK, TEAK, THIN, VERY, WANE, WEED, WILL
WEAR: AFAR, DECK, DOWN, FEAR, FRAY, GARB, KNIT, LEGS, NEAR, PEAR, REAR, RING, ROBE, SHOE, TEAR, TIRE, TOGS, WHAT, WOLF
WEED: BIND, DEAD, DRIP, DRUG, EVIL, GROW, HEMP, HIGH, KILL, MILL, NEWT, POND, REED, SEED, THIN, WANT, WEAK
WEEK: DAYS, DRAG, GALA, LIFE, NEWS, NEXT, THIS, TIME, WORK, YEAR
WEEP: BAWL, DEEP, MOAN, PINE, SIGH, TEAR, WAIL, WEEP
WEFT: LOOM
WEIR: LEER
WELD: CARS, GATE, GLUE, HEAT, IRON, JOIN, LAMP, MELT, MEND, ONTO, SILO, SPOT, WEST
WELL: AGED, ALAS, ALSO, BAKE, BEAT, BELL, BORE, BOTH, BRED, DAME, DEEP, DELL, DONE, ENDS, FAKE, FALL, FARE, FINE, FITS, FORE, GOES, GOOD, GOSH, HAIL, HILL, HOLE, HURT, ILLS, KEPT, KNEW, LIFT, LIVE, MADE, MEAN, MOLE, NIGH, NOTE, POND, POOR, READ, SELL, SHOD, SICK, SINK, SURE, TELL, VERY, WELL, WILL, WISH, WORK
WENT: AWAY, BEEN, BENT, CAME, COME, DOWN, FAST, GOES, GONE, HOME, INTO, LEFT, PAUL, SENT
WEPT: DIED, KEPT, PITY, TEAR
WERE: BEEN, EVEN, HERE, ONCE, ONLY, PAST, THEN, THEY, WHEN, WILL, WISH, WOLF
WEST: BEST, EAST, GONE, KEYS, NESS, POLE, SIDE, WARD, WELD, WEST, WILD, WIND
WHAM: BANG, BANS, BASH, BIFF, BLAM, BLOW, BOOK, BOOM, OUCH, SHAM, SLAM, SOCK, SPAM, WHIM, WHIZ
WHAT: ACNE, AMOK, BUNT, CANT, CLOT, COIF, COST, DAFT, DANK, DEAF, DIKE, DOER, DOES, DONE, DRAG, EARN, ELSE, ERGO, EVER, FACT, FEAR, FLOE, FROM, GAVE, GIRL, GOSH, HECK, IDEA, IZZY, JOIN, KANE, KILL, KNEW, KNOW, LEES, LEST, LIFE, LIKE, LING, LOTH, MAKE, MAZY, MOAN, MOOT, MORE, MOST, NEED, ONLY, PATE, QUID, QUIZ, REAL, ROTE, SAID, SEEK, SEEM, SEEN, SEXY, SIGN, SILO, SINS, SLOE, SLUG, SORT, STUB, SUCH, TELL, THAN, THAT, THEE, THEN, THUS, TIME, TOGS, TOLD, TONG, TOOK, UNTO, UPON, WANT, WEAR, WHAT, WHEN, WHOM, WILL, WONG
WHEN: BOOK, CRAP, DATE, EVEN, EVER, JUST, KNEW, KNOW, LIKE, ONLY, PAST, SEEN, SOON, THAN, THEN, THEY, TILL, TIME, WERE, WHAT, WHEN, YEAR
WHIG: TORY
WHIM: WHAM
WHIP: BACK, BEAT, BELT, BEND, BULL, CANE, CORD, FLIP, FLOG, HAND, HURT, LASH, OUCH, PAIN, REIN, ROPE, SADE, SASH, SEER, STIR, TOGA, WIPE
WHIZ: WHAM
WHOM: BELL, DOES, GIVE, HATE, HOME, LEST, LOVE, SAID, THEM, TURN, UNTO, UPON, WHAT, WITH
WICK: BURN, CORK, DICK, FIRE, LAMP, PICK, TOWN
WIDE: AREA, BEAM, BENT, DEEP, EYED, FLAT, GULF, GULP, HIDE, HIGH, HIPS, LONG, OPEN, ROAD, ROAM, SPAN, VAST, VIEW, WAKE
WIFE: ANNA, BABY, BATH, BEAT, BOSS, FISH, FOOD, FUCK, GIRL, HELL, HOME, ILLS, LADY, LOVE, MATE, OBEY, OURS, SEXY, SUES, TOOK
WIGS: FIGS, HATS, LICE, PIGS, WOGS
WILD: AMOK, BILL, BOAR, BUSH, CUBS, DUCK, EYED, FOWL, FREE, FULL, FURY, GIRL, LIFE, LION, MOOR, OATS, OPEN, RAVE, RIFE, ROAM, SWAN, TAME, UGLY, WEST, WIND, WOLF, WOOD
WILL: ABLE, COME, DARE, DEAD, DEED, FREE, HELD, HILL, KISS, MEEK, MILL, MIND, MUST, NEST, NONE, OBEY, TAKE, THEN, THEY, WANT, WEAK, WELL, WERE, WHAT, WISH, WONT, WORK
WILT: AWAY, BEND, COCK, DEAD, FADE, FLAG, FLOP, HEAT, JUDO, LILT, MELT, THOU, TILT, WAIN, WILT
WIND: AIRY, ALLY, BABY, BAGS, BLEW, BLOW, BURP, COIL, COLD, DIKE, EAST, FAIR, FART, FAST, FLAP, FLEE, FURY, GALE, GONE, HAIL, HORN, KEEN, KITE, LEES, MILD, MILL, MIND, PATH, PEAK, PIPE, POLL, PUFF, RAIN, REED, SAIL, SEAS, SEED, SIGH, SNOW, SOFT, SSSH, SWAY, TREE, TUBA, TURN, VAIN, VANE, WAVE, WEST, WILD, WOOD, WORM, WRAP
WINE: ALES, BATS, BEER, BREW, CANT, CASE, CORK, DINE, FOOD, FRET, GUMS, HART, HOPS, HOST, LEES, LIPS, LIST, MEAL, MUST, PINE, PORT, POUR, RACK, ROME, ROSE, SAKE, SHOP, SLOE, SONG, SOUR, TENT, VINE, YEAH
WING: BATS, BEAK, BIRD, BLEW, CORD, DOVE, FLAP, GULL, HALF, HAWK, HIGH, HONG, LACE, LEFT, MOTH, PORT, SIDE, SOFT, SPAN, TAIL, WARD, WONG, WORD
WINK: BIRD, BODY, EASY, EYES, GAME, GOOD, GRIN, HOOD, LASH, LOOK, LOVE, PINK, SINK, WANK
WINS: CORK, RARE
WIPE: BROW, DIRT, FEET, HAND, MARK, NOSE, OVER, TEAR, WASH, WHIP, WORK
WIRE: BARE, BEND, BORE, COIL, CORD, FIRE, FLUX, FUSE, GLOW, GOWN, HEAT, HIRE, HOOK, HOOP, LEES, LESS, LINE, LIVE, LONG, LOOP, MAST, MESH, MIKE, PLUG, ROPE, SNIP, STAY, TAPE, TAUT, THIN, WARY, WOOL, YARN
WIRY: LEAN
WISE: CITY, ELSE, EVIL, FOOL, GOOD, GRIM, KING, LIKE, SAGE, SANE, SEER, WARY
WISH: BONE, DISH, FULL, GIFT, HAVE, HOPE, LIKE, LONG, NICE, REST, SIGH, STAR, THAT, TRUE, URGE, WANT, WASH, WELL, WERE, WILL
WITE: WONG
WITH: ALSO, BEAR, BODY, CAME, CHAT, CHEZ, DEAL, DONE, EASE, FROM, GOES, GONE, HOLD, KEPT, KNIT, LOVE, POUR, SIGN, STAY, TIES, UNTO, WHOM, WITH, WORD
WITS: EATS, ENDS, FITT, FIVE, HALF, HITS, JOKE, LIFE, MIND, NITS, NONE, NUTS, PITT, TITS, TOTS
WOES: ILLS
WOGS: ARAB, BOGS, COON, DAMN, DOGS, HOGS, NICE, NOGS, PAUL, RACE, REAL, TOGS, WIGS, WOGS
WOLF: BEAR, CALL, CUBS, DOOR, FANG, FORE, GRIM, HOWL, LAIR, LAMB, LONE, LOOP, LOPE, MALE, PACK, PREY, SKIN, TALE, WARE, WEAR, WERE, WILD
WOMB: BABY, BORN, COSY, LIFE, LOOM, LOVE, MARY, TOMB, WARM
WONG: CENT, DING, DUNG, GONG, GWEN, HANG, HONG, JOKE, JUNK, KONG, PONG, SONG, TING, TONG, WHAT, WING, WITE
WONT: CANT, MUST, WILL
WOOD: BABE, BASE, BEAM, BOAT, BOWL, BULK, CHEF, CHOP, COAL, CONE, COPS, DALE, DARK, DEAL, DEER, DELL, DESK, DOOR, ELMS, FELL, FILE, FIRE, FIRS, FLEE, FREE, FUEL, GATE, HALT, HARD, HEAD, HEAP, HICK, HUTS, KNOT, LANE, LARK, LEES, LICE, LOFT, LOGS, MAST, MAZE, MOOR, NAIL, NAME, NOOK, PATH, PEAK, PEGS, PILE, PINE, PULP, RASP, RATS, REED, ROOM, RULE, SEAT, SHED, SHIP, SINK, SLAB, TEAK, TITS, TOGS, TOYS, TRAP, TREE, TWIG, VICE, WARM, WILD, WIND, WOOL, WORK, WORM, WRAP
WOOF: BARK
WOOL: BALE, BALL, CARD, COAT, COMB, COSY, CURL, DARN, EWES, EYES, HEMP, JUNE, KNIT, KNOT, LAMB, LOOM, LOOP, MILL, MOTH, NONE, PACK, RAGS, SACK, SILK, SOCK, SOFT, SPIN, SPUN, VEST, WARM, WIRE, WOOD, YARD, YARN
WORD: AXIS, BOOK, CLUE, DAMN, DEED, DOER, EARN, EDIT, FORM, GAME, LAST, LIMY, LINE, LING, LINK, LIST, MOOT, NAME, NEXT, NOUN, OATH, OMIT, PAGE, PASS, PINE, PULP, QUIZ, READ, SAID, SHIT, SILO, STEP, SUCH, TASK, TELL, TEST, TEXT, THAT, THEY, USED, VERB, WING, WITH, WORD
WORK: BEST, BOOK, BORE, BOSS, BOUT, BUSY, CASE, CHAR, CHEF, DANK, DAYS, DEED, DESK, DOER, DOES, DONE, DULL, DUST, EARN, EASE, EASY, EDIT, ERGO, EXAM, FAIL, FARM, FAST, FILE, FRET, GOAL, HARD, IDLE, KEEN, LACE, LAZY, LIFE, LINK, LOAD, MADE, MAID, MARK, MATE, MESH, MUCH, NICE, PACE, PAID, PEST, PLAY, POEM, RAKE, RATE, REST, ROPE, SACK, SALE, SALT, SCAR, SHOP, SITE, SLOW, SUMS, TASK, TEAM, TELL, TEXT, TIRE, TOIL, TOOL, UNIT, WAGE, WEEK, WELL, WILL, WIPE, WOOD
WORM: BAIT, BIRD, BOOK, CAST, FISH, FLAT, GLOW, GRUB, HOLE, INCH, LIKE, LUNG, MEAL, MOLE, MOVE, PEAS, RING, SILK, SLOE, SLOW, SLUG, SOIL, TAPE, THIN, TURN, WIND, WOOD
WORN: AGED, RUST, USED
WRAP: COAT, COLD, COSY, MINK, PACK, ROLL, WARM, WIND, WOOD
WREN: NAVY
WRIT: HOLY, SUES
XMAS: FIGS, LENT, TOYS
YALE: KEYS, LOCK
YANK: ARMY, BANK, BURN, DIME, FAKE, HECK, JEEP, JOLT, LIMY, PULL, PUSS, TANK, TOUR, WANK
YARD: AREA, BACK, BARN, BIRD, BOAT, COAL, COWS, DOCK, FARM, FEET, FOOT, HALL, INCH, JUNK, LONG, MILE, PLAY, PUMP, SHED, SHIP, VINE, WALL, WOOL
YARN: CLAM, DARN, FLAX, JOKE, KNIT, LOAN, ROPE, SPIN, SPUN, STAY, TALE, TALK, WIRE, WOOL
YAWN: BORE, GAPE, GASP, LAWN, OPEN, PUKE, SIGH, THIS, TIRE
YEAH: CRAP, GASP, SONG, SURE, WINE, YEAH
YEAR: ANUS, BOOK, DATE, DAYS, FIND, LAST, LEAP, LONG, NEXT, NOSE, OURS, OVER, THIS, TIME, WEEK, WHEN
YELL: BABY, BAWL, BELL, FELL, FIRE, GIRL, HELL, HELP, HOWL, LOAD, LOUD, OUCH, PACK, PAIN, RAPE, RASP, ROAR, SHOW, SINK
YELP: HOWL
YETI: SNOB
YOGA: TOGA
YOLK: EGGS, JOKE, MILK, OXEN, YORK
YORK: CITY, DUKE, HAMS, MASK, ROSE, TOWN, YOLK
YOUR: BABY, BOOK, BOSS, EYES, HAND, HERE, KNEE, LIFE, LOSS, MINE, NAME, OURS, SAKE, SELF, TAKE, THEE, THOU, TIME, TURN
ZERO: COLD, DUCK, HOUR, NILL, NINE, NONE
ZEST: LEST
ZINC: LEAD
ZING: TANG, TING
ZONE: AREA
ZOOM: LENS, LOOM, SOAR
